Name,Chromosome,Start,End,prom_length,GC
TFC3,1,151209,151909,700,0.29285714285714287
VPS8,1,143380,143611,231,0.31601731601731603
EFB1,1,141492,142152,660,0.36818181818181817
SSA1,1,141493,142153,660,0.36818181818181817
ERP2,1,138414,139114,700,0.3457142857142857
FUN14,1,136755,136865,110,0.3181818181818182
SPO7,1,135701,135822,121,0.2727272727272727
MDM10,1,135702,135823,121,0.2644628099173554
SWC3,1,132081,132194,113,0.36283185840707965
CYS3,1,130587,130741,154,0.37662337662337664
DEP1,1,129066,129235,169,0.33727810650887574
SYN8,1,129067,129236,169,0.33727810650887574
NTG1,1,128074,128118,44,0.20454545454545456
TPD3,1,124445,124785,340,0.3088235294117647
PSK1,1,119161,119861,700,0.37285714285714283
FUN30,1,114636,114812,176,0.4318181818181818
ATS1,1,114637,114813,176,0.4375
CCR4,1,113418,113539,121,0.4380165289256198
FUN26,1,110446,110616,170,0.3058823529411765
PMT2,1,108640,108835,195,0.3230769230769231
LTE1,1,105986,106157,171,0.30994152046783624
MAK16,1,101168,101482,314,0.267515923566879
DRS2,1,99783,100024,241,0.31950207468879666
SAW1,1,94528,94605,77,0.3116883116883117
FRT2,1,92521,92835,314,0.321656050955414
MYO4,1,92522,92836,314,0.321656050955414
SNC1,1,87077,87263,186,0.3602150537634409
GIP4,1,87078,87264,186,0.3548387096774194
PRP45,1,84494,84664,170,0.32941176470588235
POP5,1,82584,82700,116,0.31896551724137934
FUN19,1,82585,82701,116,0.3275862068965517
FUN12,1,76399,76400,1,1.0
RBG1,1,76184,76400,216,0.4166666666666667
YAL037W,1,73451,73452,1,0.0
CDC19,1,71058,71758,700,0.3657142857142857
CYC3,1,69581,70281,700,0.3742857142857143
CLN3,1,67844,68544,700,0.42428571428571427
CDC24,1,62653,62775,122,0.4180327868852459
ERV46,1,61071,61293,222,0.3783783783783784
PTA1,1,61072,61294,222,0.3783783783783784
GCV3,1,58471,58619,148,0.43243243243243246
AIM1,1,57415,57517,102,0.35294117647058826
SPC72,1,56886,56907,21,0.23809523809523808
GEM1,1,54790,54934,144,0.2777777777777778
AIM2,1,52661,53361,700,0.38857142857142857
OAF1,1,48321,48533,212,0.3867924528301887
FLC2,1,45067,45758,691,0.3849493487698987
ACS1,1,45068,45759,691,0.3849493487698987
PEX22,1,41998,42169,171,0.27485380116959063
GPB2,1,39162,39211,49,0.3877551020408163
CNE1,1,37331,37414,83,0.3132530120481928
ECM1,1,36386,36506,120,0.2916666666666667
BDH1,1,34916,35106,190,0.4105263157894737
BDH2,1,33014,33358,344,0.43023255813953487
GDH3,1,30828,31528,700,0.3142857142857143
SEO1,1,9260,9960,700,0.35
NUP60,1,151514,152214,700,0.28
SWD1,1,154745,154919,174,0.27586206896551724
RFA1,1,158682,158872,190,0.3473684210526316
SEN34,1,158681,158871,190,0.3473684210526316
BUD14,1,169021,169277,256,0.36328125
ADE1,1,169020,169276,256,0.36328125
KIN3,1,171719,172165,446,0.28699551569506726
CDC15,1,175181,175881,700,0.38285714285714284
YAR023C,1,180697,181397,700,0.3742857142857143
UIP3,1,182970,183670,700,0.3314285714285714
YAR028W,1,184654,184847,193,0.42487046632124353
YAR029W,1,184847,184852,5,0.2
MST28,1,187350,188050,700,0.41
YAT1,1,189448,190148,700,0.4085714285714286
SWH1,1,192359,192582,223,0.3721973094170404
ECM15,2,237478,238178,700,0.32571428571428573
HTB2,2,235818,236468,650,0.34
HTA2,2,235819,236469,650,0.34
UTP20,2,226824,227524,700,0.3514285714285714
PDR3,2,217143,217407,264,0.42803030303030304
LDB7,2,217144,217408,264,0.42803030303030304
SLA1,2,216418,217118,700,0.45714285714285713
HIR1,2,209349,209597,248,0.32661290322580644
ALK2,2,206959,207159,200,0.305
YBL010C,2,206960,207160,200,0.305
SCT1,2,202736,203436,700,0.4828571428571429
FMT1,2,201776,202011,235,0.3574468085106383
RRN6,2,201777,202012,235,0.3574468085106383
ACH1,2,193332,194032,700,0.47714285714285715
PEP1,2,191792,192492,700,0.35714285714285715
POP8,2,186512,186776,264,0.375
APN2,2,184204,184300,96,0.28125
RFT1,2,182119,182323,204,0.43137254901960786
HAP3,2,182120,182324,204,0.4362745098039216
PIM1,2,181398,181490,92,0.43478260869565216
MCM2,2,177579,177798,219,0.319634703196347
NCL1,2,172383,172510,127,0.31496062992125984
RRN10,2,171165,171422,257,0.3540856031128405
LSM2,2,169864,170564,700,0.33714285714285713
RPL19B,2,167884,168391,507,0.4161735700197239
YBL028C,2,167885,168392,507,0.4181459566074951
YBL029W,2,165391,166091,700,0.3485714285714286
PET9,2,164118,164364,246,0.4634146341463415
SHE1,2,161508,161668,160,0.35
HEK2,2,159720,160091,371,0.40161725067385445
RIB1,2,159721,160092,371,0.39892183288409705
STU1,2,158448,158589,141,0.3262411347517731
POL12,2,153691,153736,45,0.13333333333333333
YBL036C,2,151233,151447,214,0.3364485981308411
APL3,2,146943,147115,172,0.4011627906976744
MRPL16,2,145782,146123,341,0.2961876832844575
URA7,2,145783,146124,341,0.2961876832844575
ERD2,2,142911,143108,197,0.41116751269035534
PRE7,2,140511,141211,700,0.42857142857142855
FUI1,2,140320,141020,700,0.4157142857142857
ECM13,2,135856,136556,700,0.44
COR1,2,135702,136402,700,0.4514285714285714
PSY4,2,132215,132419,204,0.35784313725490197
EDE1,2,132216,132420,204,0.35784313725490197
SEC17,2,124819,125047,228,0.40789473684210525
PIN4,2,124820,125048,228,0.40789473684210525
SAS3,2,122124,122302,178,0.3202247191011236
TOD6,2,117132,117473,341,0.39002932551319647
YBL055C,2,117133,117474,341,0.39002932551319647
PTC3,2,113446,113706,260,0.36923076923076925
PTH2,2,113447,113707,260,0.36923076923076925
SHP1,2,111404,111408,4,0.75
YBL059W,2,110560,110676,116,0.3275862068965517
YEL1,2,107514,107913,399,0.3558897243107769
SKT5,2,107515,107914,399,0.3558897243107769
KIP1,2,101187,101868,681,0.41409691629955947
PRX1,2,101188,101869,681,0.41409691629955947
SEF1,2,100169,100299,130,0.33076923076923076
UBP13,2,96164,96444,280,0.3357142857142857
PRS4,2,92110,92371,261,0.3793103448275862
AST1,2,90580,90653,73,0.1643835616438356
YBL071C,2,90581,90654,73,0.1643835616438356
RPS8A,2,89142,89610,468,0.3525641025641026
AAR2,2,87790,88403,613,0.3605220228384992
SSA3,2,87511,87790,279,0.3942652329749104
ILS1,2,84278,84418,140,0.3357142857142857
ATG8,2,80775,80947,172,0.38953488372093026
NUP170,2,74723,75187,464,0.3168103448275862
PET112,2,74724,75188,464,0.3146551724137931
YBL081W,2,71169,71551,382,0.387434554973822
ALG3,2,71170,71552,382,0.387434554973822
YBL083C,2,71170,71552,382,0.387434554973822
CDC27,2,69568,69697,129,0.3643410852713178
BOI1,2,62839,63539,700,0.37
YBL086C,2,62679,63379,700,0.37857142857142856
RPL23A,2,60762,61155,393,0.37404580152671757
TEL1,2,59649,59722,73,0.3013698630136986
AVT5,2,49480,49513,33,0.24242424242424243
MRP21,2,48649,48807,158,0.34810126582278483
MAP2,2,48650,48808,158,0.34810126582278483
RPL32,2,45016,45612,596,0.4161073825503356
ROX3,2,44998,45017,19,0.42105263157894735
YBL094C,2,45017,45613,596,0.4161073825503356
YBL095W,2,43181,43260,79,0.35443037974683544
BRN1,2,40563,40772,209,0.2631578947368421
BNA4,2,38921,39123,202,0.33663366336633666
ATP1,2,36032,36732,700,0.39571428571428574
ECM21,2,28406,29106,700,0.3557142857142857
SFT2,2,23789,24009,220,0.4
RTG3,2,23790,24010,220,0.4
YBL104C,2,21299,21602,303,0.3564356435643564
PKC1,2,17962,18086,124,0.3790322580645161
SRO77,2,13917,14104,187,0.3422459893048128
YBL107C,2,10559,10869,310,0.3419354838709677
NTH2,2,241339,241544,205,0.28292682926829266
RER2,2,242589,242780,191,0.3403141361256545
COQ1,2,242588,242779,191,0.3403141361256545
GPI18,2,245683,245866,183,0.3442622950819672
RCR1,2,245682,245865,183,0.33879781420765026
UGA2,2,246702,246883,181,0.430939226519337
DSF2,2,251096,251796,700,0.4157142857142857
FLR1,2,254430,255130,700,0.3171428571428571
HHF1,2,255721,256303,582,0.39347079037800686
HHT1,2,255720,256302,582,0.3951890034364261
IPP1,2,258006,258706,700,0.37285714285714283
GRX7,2,267396,267569,173,0.3815028901734104
MNN2,2,269631,270211,580,0.44655172413793104
YBR016W,2,269630,270210,580,0.4482758620689655
KAP104,2,273755,274272,517,0.30754352030947774
GAL7,2,275547,276169,622,0.36816720257234725
GAL10,2,278377,278963,586,0.38054607508532423
GAL1,2,278376,278962,586,0.38054607508532423
FUR4,2,280716,281344,628,0.3487261146496815
POA1,2,283470,283675,205,0.34146341463414637
CHS3,2,288059,288759,700,0.38857142857142857
SCO2,2,288631,289331,700,0.38142857142857145
OLA1,2,291902,292602,700,0.3557142857142857
ETR1,2,294067,294249,182,0.41208791208791207
YBR028C,2,296043,296238,195,0.28205128205128205
CDS1,2,297822,298226,404,0.3787128712871287
RKM3,2,297821,298225,404,0.3811881188118812
RPL4A,2,300005,300149,144,0.25
HMT1,2,305997,306169,172,0.3430232558139535
PDX3,2,306985,307685,700,0.36714285714285716
CSG2,2,310361,310495,134,0.4253731343283582
SCO1,2,311493,311851,358,0.33798882681564246
CHS2,2,311492,311850,358,0.33519553072625696
ATP3,2,314974,315495,521,0.3723608445297505
FAT1,2,317512,318212,700,0.32285714285714284
CST26,2,321654,321739,85,0.3176470588235294
QDR3,2,324071,324265,194,0.36597938144329895
TCM62,2,326092,326792,700,0.3657142857142857
GIP1,2,330230,330236,6,0.5
ZTA1,2,331544,331813,269,0.3754646840148699
FMP23,2,331543,331812,269,0.37174721189591076
RPS11B,2,332460,332812,352,0.3977272727272727
REB1,2,336865,337145,280,0.41785714285714287
REG2,2,338387,338663,276,0.4492753623188406
RFS1,2,339413,339606,193,0.38341968911917096
YBR053C,2,340763,341463,700,0.3485714285714286
YRO2,2,342083,342783,700,0.3657142857142857
PRP6,2,347322,347858,536,0.3414179104477612
YBR056W,2,347321,347857,536,0.3414179104477612
MUM2,2,353383,353652,269,0.24907063197026022
UBP14,2,356039,356153,114,0.37719298245614036
AKL1,2,360325,360595,270,0.3296296296296296
ORC2,2,362601,363301,700,0.3557142857142857
TRM7,2,365732,365869,137,0.32116788321167883
YBR062C,2,366612,366913,301,0.3687707641196013
YBR063C,2,369713,369720,7,0.42857142857142855
ECM2,2,369720,369938,218,0.38073394495412843
NRG2,2,370759,371459,700,0.40714285714285714
TIP1,2,372786,373486,700,0.39285714285714285
BAP2,2,375729,376412,683,0.4143484626647145
TAT1,2,378538,379178,640,0.3859375
ALG14,2,379972,380339,367,0.37329700272479566
YBR071W,2,379971,380338,367,0.37329700272479566
HSP26,2,381315,381955,640,0.41875
RDH54,2,382837,383139,302,0.3443708609271523
YBR074W,2,385995,386280,285,0.29473684210526313
SLM4,2,392339,392947,608,0.41776315789473684
ECM33,2,392338,392946,608,0.41776315789473684
RPG1,2,398302,398486,184,0.375
SEC18,2,400916,401129,213,0.36619718309859156
SPT7,2,405393,406093,700,0.36857142857142855
UBC4,2,407255,407955,700,0.35
TEC1,2,408193,408893,700,0.42714285714285716
MIS1,2,410710,411039,329,0.3860182370820669
AAC3,2,415283,415907,624,0.41185897435897434
IST2,2,423333,423754,421,0.3254156769596199
RFC5,2,423332,423753,421,0.3254156769596199
POL30,2,425806,426017,211,0.36018957345971564
TIM12,2,427525,427647,122,0.3114754098360656
PHO3,2,429127,429481,354,0.3305084745762712
PHO5,2,430986,431686,700,0.3985714285714286
PBY1,2,431275,431975,700,0.39
RXT2,2,435723,435960,237,0.35864978902953587
YBR096W,2,435722,435959,237,0.3628691983122363
VPS15,2,436780,436908,128,0.28125
MMS4,2,441292,441495,203,0.2955665024630542
YBR099C,2,444740,444743,3,0.0
FES1,2,444743,444952,209,0.41148325358851673
EXO84,2,447387,447543,156,0.33974358974358976
SIF2,2,447386,447542,156,0.34615384615384615
YMC2,2,449363,449583,220,0.37272727272727274
VID24,2,452000,452619,619,0.40226171243941844
PHO88,2,451999,452618,619,0.40226171243941844
IML3,2,454579,454770,191,0.3769633507853403
AIM3,2,454578,454769,191,0.3769633507853403
CMD1,2,458406,458812,406,0.35960591133004927
ALG1,2,458405,458811,406,0.3620689655172414
YSA1,2,461881,462102,221,0.4117647058823529
CYC8,2,465970,466670,700,0.44857142857142857
RAD16,2,466459,467159,700,0.43857142857142856
LYS2,2,474034,474734,700,0.3985714285714286
TEF2,2,476948,477648,700,0.36714285714285716
MUD1,2,479136,479289,153,0.3660130718954248
CBP6,2,481008,481228,220,0.37272727272727274
GRS1,2,483434,483774,340,0.3411764705882353
MRPL36,2,484536,484696,160,0.34375
TFC1,2,486754,486858,104,0.38461538461538464
PTC4,2,488562,488774,212,0.3867924528301887
TPS1,2,490484,490827,343,0.521865889212828
VMA2,2,492871,493010,139,0.2949640287769784
ATG14,2,494202,494268,66,0.19696969696969696
OPY1,2,495383,495479,96,0.3958333333333333
SHE3,2,496929,497133,204,0.36764705882352944
CCZ1,2,496928,497132,204,0.36764705882352944
AGP2,2,501606,501744,138,0.427536231884058
HSL7,2,504416,504760,344,0.37209302325581395
CKS1,2,504415,504759,344,0.37209302325581395
MEC1,2,505411,505629,218,0.3165137614678899
YBR137W,2,512965,512981,16,0.25
YBR138C,2,515376,515656,280,0.36428571428571427
YBR139W,2,515375,515655,280,0.3607142857142857
IRA1,2,526898,527150,252,0.39285714285714285
YBR141C,2,528069,528259,190,0.35789473684210527
MAK5,2,528068,528258,190,0.35789473684210527
SUP45,2,532210,532910,700,0.36
ADH5,2,533020,533720,700,0.37
MRPS9,2,534917,535196,279,0.33691756272401435
RTC2,2,536295,536461,166,0.3373493975903614
YSW1,2,537480,537933,453,0.3818984547461369
ARA1,2,539637,539948,311,0.35691318327974275
TBS1,2,544522,544915,393,0.34096692111959287
APD1,2,544521,544914,393,0.34096692111959287
SPP381,2,546107,546307,200,0.305
RIB7,2,546307,546372,65,0.3384615384615385
RPB5,2,549100,549734,634,0.3580441640378549
CNS1,2,549099,549733,634,0.3580441640378549
SLI15,2,553250,553414,164,0.3170731707317073
ICS2,2,555160,555860,700,0.42428571428571427
AMN1,2,555585,556285,700,0.39
IFA38,2,558350,558631,281,0.3701067615658363
CDC28,2,559893,559999,106,0.29245283018867924
CSH1,2,561067,561406,339,0.37168141592920356
TOS1,2,564719,565214,495,0.3515151515151515
EXO5,2,565512,565620,108,0.37962962962962965
ARL1,2,568545,568760,215,0.32558139534883723
UBS1,2,568544,568759,215,0.32558139534883723
TYR1,2,571243,571355,112,0.25
POP7,2,571947,572241,294,0.3163265306122449
PEX32,2,571946,572240,294,0.3163265306122449
SSE2,2,576050,576214,164,0.29878048780487804
NPL4,2,578120,578338,218,0.3394495412844037
SEC66,2,578119,578337,218,0.3394495412844037
SMY2,2,581477,581545,68,0.36764705882352944
UMP1,2,582196,582395,199,0.40703517587939697
YBR174C,2,583410,583458,48,0.25
SWD3,2,582195,582394,199,0.4120603015075377
ECM31,2,583457,583628,171,0.36257309941520466
EHT1,2,586192,586476,284,0.3591549295774648
FZO1,2,589179,589879,700,0.38142857142857145
RPS6B,2,592803,593129,326,0.4171779141104294
SMP1,2,595025,595204,179,0.39106145251396646
YPC1,2,595605,596017,412,0.3737864077669903
YBR184W,2,597145,597348,203,0.32019704433497537
MBA1,2,599978,600678,700,0.35714285714285715
GDT1,2,601811,602511,700,0.3757142857142857
NTC20,2,604182,604482,300,0.36666666666666664
RPS9B,2,604181,604481,300,0.36666666666666664
YBR190W,2,604481,604484,3,0.3333333333333333
RPL21A,2,605572,606247,675,0.41185185185185186
RIM2,2,607282,607451,169,0.35502958579881655
MED8,2,609788,609969,181,0.281767955801105
AIM4,2,609787,609968,181,0.287292817679558
MSI1,2,611925,612069,144,0.3541666666666667
PGI1,2,613937,614637,700,0.38
YBR197C,2,615884,616043,159,0.39622641509433965
TAF5,2,618601,618810,209,0.3588516746411483
KTR4,2,618600,618809,209,0.3588516746411483
BEM1,2,620430,620808,378,0.328042328042328
DER1,2,622748,623439,691,0.32416787264833574
MCM7,2,625027,625727,700,0.37857142857142856
COS111,2,628485,628940,455,0.4175824175824176
YBR204C,2,633425,633575,150,0.37333333333333335
KTR3,2,633424,633574,150,0.37333333333333335
YBR206W,2,633424,633574,150,0.37333333333333335
FTH1,2,635001,635091,90,0.3
DUR1_2,2,642673,643373,700,0.4057142857142857
ERV15,2,644813,645513,700,0.36
AME1,2,647241,647480,239,0.3682008368200837
NGR1,2,647240,647479,239,0.3723849372384937
MET8,2,650109,650297,188,0.3404255319148936
SDS24,2,650635,651335,700,0.48142857142857143
HPC2,2,653189,653318,129,0.34108527131782945
YBP1,2,657630,657768,138,0.3188405797101449
ATG12,2,657629,657767,138,0.3188405797101449
PYC2,2,662313,662759,446,0.40358744394618834
YBR220C,2,664737,664913,176,0.3522727272727273
PDB1,2,666456,666607,151,0.44370860927152317
PCS60,2,668391,668416,25,0.4
TDP1,2,670317,671017,700,0.38142857142857145
MCX1,2,675192,675301,109,0.21100917431192662
SLX1,2,675191,675300,109,0.21100917431192662
ROT2,2,679228,679389,161,0.38509316770186336
OM14,2,680078,680314,236,0.5169491525423728
SWC5,2,683147,683349,202,0.3316831683168317
PBP2,2,683146,683348,202,0.33663366336633666
ARC40,2,686638,686820,182,0.35714285714285715
YBR235W,2,686637,686819,182,0.3516483516483517
ABD1,2,691731,691919,188,0.2978723404255319
PRP5,2,691730,691918,188,0.2978723404255319
YBR238C,2,697393,698093,700,0.37714285714285717
ERT1,2,700093,700401,308,0.2727272727272727
THI2,2,702409,702533,124,0.3467741935483871
YBR241C,2,704089,704516,427,0.34660421545667447
YBR242W,2,704088,704515,427,0.3442622950819672
ALG7,2,706837,707486,649,0.34514637904468415
GPX2,2,706836,707485,649,0.3436055469953775
ISW1,2,711393,711554,161,0.2919254658385093
RRT2,2,711392,711553,161,0.2919254658385093
ENP1,2,714479,714727,248,0.33064516129032256
HIS7,2,716528,716765,237,0.350210970464135
ARO4,2,718084,718333,249,0.30522088353413657
SPO23,2,718083,718332,249,0.30120481927710846
MRPS5,2,720648,721348,700,0.34285714285714286
DUT1,2,722393,722592,199,0.2814070351758794
SRB6,2,723125,723215,90,0.36666666666666664
TRS20,2,724271,724420,149,0.28187919463087246
MTC4,2,724270,724419,149,0.28187919463087246
RIB5,2,728110,728810,700,0.36
POP4,2,728135,728835,700,0.35714285714285715
SHG1,2,730195,730341,146,0.2945205479452055
YBR259W,2,730194,730340,146,0.2945205479452055
RGD1,2,734648,734704,56,0.26785714285714285
TAE1,2,735555,735604,49,0.4489795918367347
AIM5,2,736081,736224,143,0.34265734265734266
SHM1,2,736080,736223,143,0.34265734265734266
YPT10,2,738394,738546,152,0.3092105263157895
TSC10,2,738393,738545,152,0.3092105263157895
REI1,2,739676,739823,147,0.3197278911564626
MRPL37,2,741141,741280,139,0.3669064748201439
FMP21,2,742597,742723,126,0.40476190476190477
BIT2,2,744670,744826,156,0.3076923076923077
YBR271W,2,744669,744825,156,0.3076923076923077
HSM3,2,747810,747963,153,0.26143790849673204
UBX7,2,749402,749544,142,0.3591549295774648
CHK1,2,749401,749543,142,0.3591549295774648
RIF1,2,757241,757550,309,0.3333333333333333
PPS1,2,760138,760272,134,0.3208955223880597
DPB3,2,760137,760271,134,0.31343283582089554
PAF1,2,760990,761223,233,0.27467811158798283
SAF1,2,764720,764844,124,0.4274193548387097
DUG2,2,767647,768202,555,0.33693693693693694
MRPL27,2,767646,768201,555,0.33693693693693694
SSH1,2,770559,770892,333,0.3843843843843844
YBR284W,2,770558,770891,333,0.3813813813813814
YBR285W,2,773079,773779,700,0.4057142857142857
APE3,2,774371,774671,300,0.29
YBR287W,2,776379,776533,154,0.33116883116883117
APM3,2,779498,779645,147,0.3197278911564626
SNF5,2,779497,779644,147,0.3197278911564626
BSD2,2,782435,782577,142,0.323943661971831
CTP1,2,784608,785308,700,0.33
VBA2,2,786392,787092,700,0.3657142857142857
PCA1,2,792097,792797,700,0.29714285714285715
PHO89,2,798588,799288,700,0.3557142857142857
MAL33,2,799783,800483,700,0.3628571428571429
MAL31,2,804872,805572,700,0.3742857142857143
RER1,3,111701,111889,188,0.40425531914893614
YCL002C,3,111702,111890,188,0.39893617021276595
PGS1,3,108927,109026,99,0.41414141414141414
LDB16,3,107522,107980,458,0.39082969432314413
STP22,3,106861,106998,137,0.35036496350364965
ILV6,3,105572,106272,700,0.4614285714285714
SGF29,3,104370,104471,101,0.42574257425742573
GBP2,3,103396,104096,700,0.45
BUD3,3,95794,96185,391,0.36061381074168797
DCC1,3,95795,96186,391,0.36061381074168797
NFS1,3,94372,94479,107,0.42990654205607476
LEU2,3,90595,91295,700,0.3442857142857143
KCC4,3,78405,79105,700,0.3914285714285714
AGP1,3,77945,78645,700,0.45571428571428574
RNQ1,3,69970,70117,147,0.40816326530612246
BIK1,3,69971,70118,147,0.40816326530612246
HIS4,3,68393,69093,700,0.4042857142857143
RRP7,3,65601,65827,226,0.34513274336283184
STE50,3,63292,63387,95,0.3473684210526316
MXR2,3,63293,63388,95,0.3473684210526316
LSB5,3,61201,61607,406,0.35714285714285715
GRX1,3,61202,61608,406,0.35960591133004927
GFD2,3,58744,58987,243,0.37448559670781895
SRO9,3,58745,58988,243,0.37448559670781895
ATG22,3,56586,56801,215,0.33488372093023255
GID7,3,52517,52624,107,0.38317757009345793
GLK1,3,50394,50808,414,0.4758454106280193
YCL042W,3,50257,50394,137,0.32116788321167883
PDI1,3,50258,50395,137,0.32116788321167883
MGR1,3,48417,48557,140,0.39285714285714285
EMC1,3,46945,47645,700,0.4114285714285714
YCL047C,3,44448,44562,114,0.3508771929824561
YCL049C,3,40779,41417,638,0.3730407523510972
APA1,3,38863,39563,700,0.3457142857142857
LRE1,3,35435,35584,149,0.28187919463087246
PBN1,3,35436,35585,149,0.2751677852348993
SPB1,3,30728,31428,700,0.32
KAR4,3,27382,27903,521,0.33397312859884837
YCL056C,3,27383,27904,521,0.33397312859884837
PRD1,3,24352,24759,407,0.3857493857493858
KRR1,3,23404,23562,158,0.2911392405063291
MRC1,3,22172,22323,151,0.37748344370860926
VAC17,3,16898,17249,351,0.38461538461538464
CHA1,3,16899,17250,351,0.38461538461538464
CDC10,3,118403,118598,195,0.3384615384615385
MRPL32,3,118402,118597,195,0.3384615384615385
YCP4,3,120424,120800,376,0.34308510638297873
CIT2,3,122385,123085,700,0.4328571428571429
YCR007C,3,127386,128027,641,0.3915756630265211
SAT4,3,127385,128026,641,0.39313572542901715
RVS161,3,131595,132091,496,0.34475806451612906
ADY2,3,133236,133667,431,0.48491879350348027
ADP1,3,137005,137705,700,0.4014285714285714
PGK1,3,137005,137705,700,0.4014285714285714
POL4,3,141096,141136,40,0.225
YCR015C,3,142200,142900,700,0.32857142857142857
YCR016W,3,142907,143607,700,0.33
CWH43,3,147663,148363,700,0.3314285714285714
MAK32,3,151998,152698,700,0.31857142857142856
PET18,3,155105,155110,5,0.8
HSP30,3,157214,157914,700,0.39571428571428574
YCR022C,3,158029,158297,268,0.40298507462686567
YCR023C,3,160450,160602,152,0.34210526315789475
SLM5,3,162241,162409,168,0.3392857142857143
YCR025C,3,165446,166146,700,0.40285714285714286
NPP1,3,166413,166737,324,0.3148148148148148
RHB1,3,168174,168874,700,0.3442857142857143
FEN2,3,172542,172758,216,0.35185185185185186
SYP1,3,176523,177223,700,0.3485714285714286
RPS14A,3,178241,178941,700,0.3557142857142857
BPH1,3,178713,179413,700,0.3628571428571429
SNT1,3,186053,186285,232,0.3146551724137931
FEN1,3,190333,190565,232,0.3146551724137931
RRP43,3,193038,193288,250,0.328
RBK1,3,193037,193287,250,0.328
PHO87,3,197234,197934,700,0.33714285714285713
TAF2,3,205418,206095,677,0.2658788774002954
YCR043C,3,206677,206788,111,0.3333333333333333
PER1,3,207957,208134,177,0.3333333333333333
IMG1,3,210429,210517,88,0.4659090909090909
BUD23,3,211625,211875,250,0.448
ARE1,3,211624,211874,250,0.444
YCR051W,3,213975,214046,71,0.3380281690140845
RSC6,3,214870,214960,90,0.32222222222222224
THR4,3,215952,216652,700,0.4042857142857143
CTR86,3,220137,220344,207,0.357487922705314
PWP2,3,223290,223990,700,0.48142857142857143
YIH1,3,224247,224382,135,0.2962962962962963
TAH1,3,224246,224381,135,0.2962962962962963
YCR061W,3,224837,225537,700,0.3757142857142857
BUD31,3,228090,228295,205,0.40487804878048783
YCR064C,3,228509,229153,644,0.4161490683229814
HCM1,3,228508,229152,644,0.4161490683229814
RAD18,3,231333,231449,116,0.35344827586206895
SED4,3,236441,237088,647,0.34312210200927357
ATG15,3,236440,237087,647,0.34312210200927357
CPR4,3,238207,238907,700,0.48714285714285716
IMG2,3,240580,240701,121,0.39669421487603307
RSA4,3,242378,242516,138,0.2753623188405797
SSK22,3,246648,246945,297,0.37373737373737376
ERS1,3,248825,248961,136,0.3161764705882353
YCR076C,3,250062,250102,40,0.325
PAT1,3,252670,252818,148,0.3581081081081081
PTC6,3,252669,252817,148,0.3581081081081081
SRB8,3,254298,254324,26,0.3076923076923077
AHC2,3,258844,258852,8,0.375
TRX3,3,259375,259542,167,0.3592814371257485
TUP1,3,262677,263342,665,0.3398496240601504
CSM1,3,262676,263341,665,0.3398496240601504
ABP1,3,264502,265025,523,0.3479923518164436
FIG2,3,266978,267148,170,0.38823529411764707
YCR090C,3,272900,273600,700,0.2885714285714286
KIN82,3,273642,274342,700,0.35714285714285715
MSH3,3,279856,280045,189,0.36507936507936506
CDC39,3,279855,280044,189,0.37037037037037035
CDC50,3,286524,286708,184,0.30978260869565216
OCA4,3,289296,289478,182,0.34615384615384615
GIT1,3,298664,299364,700,0.4014285714285714
YCR099C,3,303007,303010,3,0.0
YCR100C,3,303010,303710,700,0.3414285714285714
YCR102C,3,305537,306237,700,0.4014285714285714
RDS1,3,310927,310935,8,0.375
AAD3,3,310227,310927,700,0.3271428571428571
RMD1,4,447651,447909,258,0.36046511627906974
NHP10,4,447652,447910,258,0.3643410852713178
MCD1,4,443898,444598,700,0.33
ATP16,4,442344,442985,641,0.33853354134165364
MED2,4,442345,442986,641,0.3369734789391576
PTC1,4,439438,439587,149,0.3825503355704698
RPT2,4,437313,438013,700,0.3271428571428571
APC11,4,433303,433470,167,0.39520958083832336
GRX6,4,431596,432296,700,0.42
YDL012C,4,431534,432234,700,0.42428571428571427
SLX5,4,428511,428920,409,0.3251833740831296
NOP1,4,426979,427220,241,0.26556016597510373
TSC13,4,426980,427221,241,0.26556016597510373
CDC7,4,423569,424185,616,0.3814935064935065
ERP3,4,423570,424186,616,0.3814935064935065
OSH2,4,421727,422427,700,0.38142857142857145
RPN4,4,416945,417573,628,0.3885350318471338
GPM2,4,413228,413928,700,0.36428571428571427
GPD1,4,411059,411759,700,0.45285714285714285
DIA3,4,409868,410568,700,0.41285714285714287
RTK1,4,407402,408102,700,0.4057142857142857
YDL027C,4,405003,405237,234,0.31196581196581197
MPS1,4,403426,403544,118,0.2796610169491525
ARP2,4,399219,399319,100,0.34
PRP9,4,397284,397475,191,0.3507853403141361
DBP10,4,393950,394164,214,0.32710280373831774
SLM3,4,393951,394165,214,0.32242990654205606
GPR1,4,392341,392406,65,0.38461538461538464
PUS9,4,388910,389041,131,0.35877862595419846
NAT1,4,381471,382171,700,0.37285714285714283
YDL041W,4,377367,378067,700,0.36
SIR2,4,378490,378762,272,0.4007352941176471
PRP11,4,376518,376643,125,0.368
MTF2,4,375314,375371,57,0.38596491228070173
FAD1,4,373725,373891,166,0.3674698795180723
NPC2,4,370954,371187,233,0.3261802575107296
SIT4,4,368614,369314,700,0.4614285714285714
STP4,4,368261,368961,700,0.41714285714285715
KNH1,4,366006,366653,647,0.41731066460587324
LHP1,4,363618,363928,310,0.3548387096774194
SLC1,4,363619,363929,310,0.35161290322580646
PBP4,4,362432,362595,163,0.31901840490797545
MCH1,4,361371,361509,138,0.38405797101449274
PSA1,4,356908,357608,700,0.43142857142857144
MBP1,4,352485,352768,283,0.35335689045936397
YDL057W,4,351136,351406,270,0.34444444444444444
USO1,4,345076,345600,524,0.36450381679389315
RAD59,4,345077,345601,524,0.36259541984732824
TSR1,4,340900,341600,700,0.37
RPS29B,4,340820,341520,700,0.3657142857142857
YDL063C,4,340221,340461,240,0.32916666666666666
UBC9,4,337295,337457,162,0.32098765432098764
PEX19,4,337296,337458,162,0.32098765432098764
IDP1,4,334441,334813,372,0.41397849462365593
COX9,4,334438,334442,4,0.5
CBS1,4,333943,333975,32,0.3125
BDF2,4,330509,331000,491,0.4419551934826884
YDL071C,4,334442,334814,372,0.4166666666666667
YET3,4,330510,331001,491,0.4419551934826884
YDL073W,4,326220,326432,212,0.33962264150943394
BRE1,4,326221,326433,212,0.33962264150943394
RPL31A,4,321698,322194,496,0.40524193548387094
RXT3,4,321699,322195,496,0.40524193548387094
VAM6,4,320309,320474,165,0.3696969696969697
MDH3,4,316451,316869,418,0.4090909090909091
MRK1,4,314829,315260,431,0.44547563805104406
THI3,4,312656,312773,117,0.39316239316239315
RPP1A,4,310188,310475,287,0.289198606271777
RPL13A,4,307809,308394,585,0.37435897435897436
RPS16B,4,307810,308395,585,0.37435897435897436
SUB2,4,305072,305076,4,0.25
NDE2,4,302719,303144,425,0.4258823529411765
YDL086W,4,301393,301407,14,0.35714285714285715
LUC7,4,301012,301394,382,0.418848167539267
ASM4,4,300131,300831,700,0.4342857142857143
NUR1,4,296336,296526,190,0.4
RAM1,4,296337,296527,190,0.39473684210526316
UBX3,4,294847,294903,56,0.32142857142857145
SRP14,4,292407,292757,350,0.3628571428571429
PMT5,4,289606,289860,254,0.3543307086614173
PMT1,4,286736,287025,289,0.4013840830449827
RPN6,4,286737,287026,289,0.39792387543252594
SNU23,4,285175,285295,120,0.35833333333333334
BUG1,4,283211,283366,155,0.36774193548387096
GET3,4,283212,283367,155,0.36129032258064514
DUN1,4,281872,282031,159,0.31446540880503143
POL3,4,276647,276790,143,0.3356643356643357
QRI1,4,276648,276791,143,0.3356643356643357
QRI7,4,274895,275055,160,0.35625
NSE4,4,271952,272344,392,0.3673469387755102
PHO2,4,271953,272345,392,0.3673469387755102
MSS2,4,268760,268871,111,0.3063063063063063
KIN28,4,267508,267674,166,0.2891566265060241
YDL109C,4,267509,267675,166,0.28313253012048195
TMA17,4,265021,265029,8,0.625
RRP42,4,264172,264326,154,0.37012987012987014
TRM3,4,258617,258848,231,0.3722943722943723
ATG20,4,258618,258849,231,0.3722943722943723
IWR1,4,255168,255868,700,0.3657142857142857
NUP84,4,251369,251518,149,0.3422818791946309
CYK3,4,247664,248283,619,0.3570274636510501
YDL119C,4,247665,248284,619,0.3554119547657512
YFH1,4,245600,245846,246,0.36585365853658536
YDL121C,4,245601,245847,246,0.36585365853658536
UBP1,4,242324,242336,12,0.3333333333333333
SNA4,4,241268,241385,117,0.46153846153846156
YDL124W,4,239779,240213,434,0.41935483870967744
HNT1,4,239780,240214,434,0.4216589861751152
CDC48,4,238714,238902,188,0.425531914893617
PCL2,4,234188,234888,700,0.3871428571428571
VCX1,4,232157,232590,433,0.3140877598152425
YDL129W,4,230627,230918,291,0.4639175257731959
RPP1B,4,229592,229888,296,0.3547297297297297
LYS21,4,226784,227356,572,0.38286713286713286
CDC53,4,223838,224000,162,0.38271604938271603
YDL133W,4,221818,222291,473,0.3699788583509514
PPH21,4,221255,221512,257,0.36964980544747084
RDI1,4,219333,219580,247,0.3603238866396761
RPL35B,4,217203,217566,363,0.3774104683195592
ARF2,4,215785,216055,270,0.42592592592592593
RGT2,4,212474,213174,700,0.35428571428571426
SCM3,4,212097,212797,700,0.30857142857142855
RPO21,4,211164,211258,94,0.3723404255319149
BPL1,4,202632,202800,168,0.36904761904761907
CRD1,4,202633,202801,168,0.375
CCT4,4,199748,199960,212,0.39622641509433965
YDL144C,4,199749,199961,212,0.39622641509433965
COP1,4,198431,198570,139,0.43884892086330934
LDB17,4,192406,192562,156,0.3076923076923077
RPN5,4,190617,190880,263,0.3574144486692015
NOP14,4,190618,190881,263,0.3612167300380228
ATG9,4,184705,184895,190,0.3736842105263158
RPC53,4,183043,183246,203,0.3448275862068966
SAS10,4,183044,183247,203,0.3448275862068966
MSH5,4,179307,180007,700,0.3485714285714286
CLB3,4,175942,176642,700,0.44571428571428573
YDL156W,4,174622,174823,201,0.34328358208955223
YDL157C,4,174623,174824,201,0.34328358208955223
YDL158C,4,174623,174824,201,0.34328358208955223
STE7,4,172213,172434,221,0.38461538461538464
DHH1,4,172214,172435,221,0.38461538461538464
ENT1,4,167301,167697,396,0.4116161616161616
CDC9,4,167302,167698,396,0.4090909090909091
CDC36,4,164095,164240,145,0.2827586206896552
FAP7,4,164096,164241,145,0.2827586206896552
NRP1,4,163210,163374,164,0.2926829268292683
SFA1,4,158861,159561,700,0.3442857142857143
UGX2,4,158774,159474,700,0.34714285714285714
UGA3,4,155931,156297,366,0.34972677595628415
GLT1,4,155932,156298,366,0.34972677595628415
PAR32,4,147627,148151,524,0.47900763358778625
DLD1,4,147628,148152,524,0.48091603053435117
AIR2,4,145548,145748,200,0.34
YDL176W,4,141784,141959,175,0.38285714285714284
YDL177C,4,141785,141960,175,0.38285714285714284
DLD2,4,139356,139496,140,0.32142857142857145
PCL9,4,137601,138195,594,0.3484848484848485
YDL180W,4,135544,135763,219,0.3607305936073059
INH1,4,134810,135092,282,0.4432624113475177
LYS20,4,132702,133402,700,0.40285714285714286
YDL183C,4,132673,133373,700,0.4042857142857143
RPL41A,4,130506,130815,309,0.39805825242718446
VMA1,4,126464,126681,217,0.29493087557603687
YDL187C,4,126465,126682,217,0.29493087557603687
PPH22,4,125176,125358,182,0.3791208791208791
RBS1,4,121784,121986,202,0.3613861386138614
UFD2,4,121785,121987,202,0.3613861386138614
RPL35A,4,116965,117641,676,0.34467455621301774
ARF1,4,115990,116277,287,0.33797909407665505
NUS1,4,114271,114579,308,0.3474025974025974
SNF3,4,111155,111367,212,0.37264150943396224
SEC31,4,106507,107088,581,0.42168674698795183
ASF2,4,106508,107089,581,0.42168674698795183
GGC1,4,104584,104777,193,0.3160621761658031
YDL199C,4,103403,103528,125,0.44
MGT1,4,101093,101206,113,0.3893805309734513
TRM8,4,99352,99506,154,0.2987012987012987
MRPL11,4,98147,98421,274,0.3357664233576642
ACK1,4,98148,98422,274,0.33211678832116787
RTN2,4,93931,94128,197,0.3248730964467005
HEM3,4,93932,94129,197,0.3248730964467005
YDL206W,4,89931,90023,92,0.34782608695652173
GLE1,4,88108,88209,101,0.32673267326732675
NHP2,4,87250,87474,224,0.33482142857142855
CWC2,4,87251,87475,224,0.33482142857142855
UGA4,4,83835,84535,700,0.39285714285714285
YDL211C,4,80481,81181,700,0.35285714285714287
SHR3,4,77974,78403,429,0.34265734265734266
NOP6,4,77975,78404,429,0.34498834498834496
PRR2,4,76712,77216,504,0.4246031746031746
GDH2,4,74108,74335,227,0.42290748898678415
RRI1,4,70338,70572,234,0.3418803418803419
TIM22,4,68766,68869,103,0.36893203883495146
YDL218W,4,66041,66147,106,0.3867924528301887
DTD1,4,65043,65214,171,0.30409356725146197
CDC13,4,65044,65215,171,0.30994152046783624
FMP45,4,61892,61956,64,0.3125
HBT1,4,60468,60540,72,0.20833333333333334
WHI4,4,56710,57148,438,0.2625570776255708
SHS1,4,52195,52403,208,0.39903846153846156
GCS1,4,52196,52404,208,0.39903846153846156
SSB1,4,43742,44034,292,0.2979452054794521
PTP1,4,42363,42673,310,0.3161290322580645
BRE4,4,42364,42674,310,0.3161290322580645
OST4,4,38339,38467,128,0.359375
YDL233W,4,36619,36774,155,0.41935483870967744
GYP7,4,36620,36775,155,0.4129032258064516
YPD1,4,34032,34177,145,0.2896551724137931
PHO13,4,31959,32258,299,0.33444816053511706
AIM6,4,30481,30627,146,0.3424657534246575
GUD1,4,30482,30628,146,0.3424657534246575
ADY3,4,28957,29657,700,0.4585714285714286
LRG1,4,21940,22640,700,0.36857142857142855
YDL241W,4,19852,20552,700,0.35428571428571426
AAD4,4,19288,19988,700,0.3485714285714286
COS7,4,1094,1794,700,0.4142857142857143
NTH1,4,452728,453016,288,0.3333333333333333
YRB1,4,452727,453015,288,0.3333333333333333
RCR2,4,453833,454076,243,0.3374485596707819
RAD57,4,455070,455227,157,0.3503184713375796
MAF1,4,458220,458443,223,0.37668161434977576
SOK1,4,461376,461814,438,0.4360730593607306
TRP1,4,461375,461813,438,0.4337899543378995
GAL3,4,462662,463362,700,0.4014285714285714
SNQ2,4,465082,465603,521,0.45489443378119004
RPL4B,4,471120,471820,700,0.32
PSF1,4,473017,473140,123,0.34146341463414637
RAD61,4,473873,473994,121,0.36363636363636365
DAD1,4,478791,478942,151,0.44370860927152317
KCS1,4,482343,482497,154,0.3181818181818182
YDR018C,4,483873,483984,111,0.4774774774774775
GCV1,4,485375,486075,700,0.4257142857142857
DAS2,4,486545,486697,152,0.34868421052631576
FAL1,4,486544,486696,152,0.34868421052631576
CIS1,4,488689,489389,700,0.35714285714285715
SES1,4,488783,489483,700,0.3442857142857143
FYV1,4,489483,489485,2,0.5
RPS11A,4,491028,491500,472,0.4152542372881356
YDR026C,4,494411,494564,153,0.3660130718954248
VPS54,4,497441,497553,112,0.32142857142857145
REG1,4,501393,501615,222,0.3918918918918919
RAD28,4,503281,503473,192,0.3958333333333333
MIC14,4,503280,503472,192,0.3958333333333333
PST2,4,504760,505460,700,0.3657142857142857
MRH1,4,507200,507900,700,0.35714285714285715
LYS14,4,512237,512937,700,0.36714285714285716
ARO3,4,521698,521789,91,0.27472527472527475
EHD3,4,524723,525399,676,0.371301775147929
KRS1,4,524722,525398,676,0.3698224852071006
RSM10,4,539094,539794,700,0.4042857142857143
YDR042C,4,541261,541961,700,0.34285714285714286
NRG1,4,543569,544269,700,0.37714285714285717
HEM13,4,545898,546598,700,0.4228571428571429
RPC11,4,548465,548681,216,0.33796296296296297
BAP3,4,550666,551366,700,0.43
HEM12,4,551032,551732,700,0.4228571428571429
VMS1,4,553023,553216,193,0.26424870466321243
TPI1,4,556502,556999,497,0.3762575452716298
DET1,4,558106,558270,164,0.38414634146341464
DBF4,4,560779,560953,174,0.3160919540229885
CDC34,4,562516,563216,700,0.38
PST1,4,562765,563465,700,0.38285714285714284
YDR056C,4,565698,565896,198,0.30808080808080807
YOS9,4,565697,565895,198,0.30808080808080807
TGL2,4,568742,569124,382,0.39528795811518325
UBC5,4,569816,570516,700,0.3657142857142857
MAK21,4,569898,570598,700,0.36857142857142855
YDR061W,4,573813,574108,295,0.3694915254237288
LCB2,4,575892,576106,214,0.3878504672897196
AIM7,4,578442,578585,143,0.34965034965034963
RPS13,4,579186,579436,250,0.308
RRG1,4,580534,580649,115,0.3739130434782609
RTR2,4,582620,582706,86,0.3488372093023256
OCA6,4,583519,583662,143,0.3356643356643357
DOS2,4,583518,583661,143,0.3356643356643357
DOA4,4,587776,587946,170,0.3058823529411765
FMP16,4,588439,588742,303,0.38283828382838286
PAA1,4,589465,589667,202,0.3415841584158416
IPT1,4,591476,592176,700,0.43714285714285717
SNF11,4,591654,592354,700,0.4542857142857143
TPS2,4,593201,593661,460,0.4652173913043478
PPH3,4,596773,596981,208,0.27403846153846156
RAD55,4,598240,598412,172,0.31976744186046513
SED1,4,600061,600761,700,0.4057142857142857
SHU2,4,602886,603033,147,0.3469387755102041
PET100,4,602885,603032,147,0.3469387755102041
VPS41,4,603844,603975,131,0.2900763358778626
PDC2,4,610168,610349,181,0.3425414364640884
STN1,4,610167,610348,181,0.3425414364640884
RRP8,4,611350,612050,700,0.3514285714285714
TVP23,4,614038,614235,197,0.350253807106599
AFR1,4,616339,616727,388,0.40463917525773196
SSS1,4,617242,617377,135,0.32592592592592595
RRP1,4,618343,619043,700,0.35714285714285715
SLU7,4,619828,620528,700,0.36
YDR089W,4,621368,622068,700,0.3514285714285714
YDR090C,4,626112,626366,254,0.3858267716535433
RLI1,4,628588,629288,700,0.3585714285714286
UBC13,4,629141,629841,700,0.32
YDR094W,4,633573,634273,700,0.4185714285714286
GIS1,4,636179,636582,403,0.5210918114143921
MSH6,4,643930,644147,217,0.3548387096774194
GRX3,4,644987,645687,700,0.3514285714285714
BMH2,4,652017,652717,700,0.3485714285714286
TVP15,4,654654,654976,322,0.38198757763975155
ARX1,4,657489,657791,302,0.36423841059602646
STE5,4,657488,657790,302,0.3675496688741722
SPO71,4,664971,665263,292,0.3321917808219178
TMS1,4,666821,667521,700,0.35714285714285715
TMN2,4,671049,671218,169,0.3076923076923077
GSG1,4,671048,671217,169,0.3076923076923077
YDR109C,4,675855,676064,209,0.3253588516746411
FOB1,4,675854,676063,209,0.3253588516746411
ALT2,4,679985,680422,437,0.39359267734553777
PDS1,4,681702,682135,433,0.3556581986143187
YDR115W,4,681701,682134,433,0.3533487297921478
MRPL1,4,683602,683901,299,0.3010033444816054
TMA64,4,685681,685865,184,0.3804347826086957
APC4,4,685680,685864,184,0.3858695652173913
VBA4,4,687965,688131,166,0.3253012048192771
TRM1,4,693243,693458,215,0.3581395348837209
DPB4,4,693242,693457,215,0.3581395348837209
KIN1,4,694282,694395,113,0.4690265486725664
INO2,4,699547,699767,220,0.44545454545454544
YDR124W,4,699546,699766,220,0.45
ECM18,4,702739,703228,489,0.3210633946830266
SWF1,4,702738,703227,489,0.31901840490797545
ARO1,4,703760,704460,700,0.3871428571428571
MTC5,4,709319,709518,199,0.36683417085427134
SAC6,4,715428,715477,49,0.2653061224489796
FIN1,4,716650,716716,66,0.36363636363636365
YDR131C,4,718536,718701,165,0.32727272727272727
YDR132C,4,720411,720788,377,0.34748010610079577
YDR133C,4,721533,722233,700,0.4357142857142857
YDR134C,4,721533,722233,700,0.4357142857142857
YCF1,4,727594,728159,565,0.36991150442477877
RGP1,4,727593,728158,565,0.37168141592920356
HPR1,4,730393,730565,172,0.37790697674418605
RUB1,4,733975,734124,149,0.30201342281879195
MTQ2,4,733974,734123,149,0.30201342281879195
DOP1,4,740043,740347,304,0.35855263157894735
PEX7,4,741773,741851,78,0.3974358974358974
SAN1,4,744020,744228,208,0.2644230769230769
MKC7,4,746241,746673,432,0.34953703703703703
TAF12,4,746240,746672,432,0.3472222222222222
SWI5,4,750915,751560,645,0.3581395348837209
EKI1,4,750914,751559,645,0.35658914728682173
KGD2,4,755127,755575,448,0.3861607142857143
NUM1,4,755126,755574,448,0.3861607142857143
CTH1,4,765271,765680,409,0.39364303178484106
GIR2,4,765270,765679,409,0.39364303178484106
ENT5,4,768104,768395,291,0.3917525773195876
YDR154C,4,769037,769491,454,0.46916299559471364
CPR1,4,769037,769491,454,0.46916299559471364
RPA14,4,769036,769490,454,0.4669603524229075
YDR157W,4,769490,769492,2,1.0
HOM2,4,770030,770321,291,0.3161512027491409
SAC3,4,771576,771774,198,0.30808080808080807
SSY1,4,775806,775990,184,0.358695652173913
YDR161W,4,778710,779007,297,0.20202020202020202
NBP2,4,781222,781359,137,0.36496350364963503
CWC15,4,781221,781358,137,0.36496350364963503
SEC1,4,784257,784834,577,0.35528596187175043
TRM82,4,784256,784833,577,0.35701906412478335
SEC5,4,789283,789417,134,0.3208955223880597
TAF10,4,789282,789416,134,0.3208955223880597
CDC37,4,790168,790287,119,0.3697478991596639
STB3,4,794255,794955,700,0.42142857142857143
SEC7,4,802435,803135,700,0.34
HSP42,4,805834,806534,700,0.41
SUP35,4,807831,808279,448,0.34598214285714285
ARG82,4,811689,812087,398,0.43467336683417085
HMO1,4,811688,812086,398,0.4371859296482412
RSM24,4,814199,814414,215,0.4046511627906977
NGG1,4,814198,814413,215,0.4046511627906977
UBC1,4,816624,816775,151,0.33112582781456956
SDH4,4,817635,817847,212,0.41509433962264153
CSN9,4,819204,819340,136,0.29411764705882354
SCC2,4,820869,821150,281,0.34519572953736655
SAS4,4,827369,827532,163,0.3067484662576687
CDC1,4,827368,827531,163,0.3067484662576687
PLP1,4,829169,829543,374,0.3449197860962567
ATC1,4,831542,831773,231,0.2987012987012987
UPS3,4,832576,832737,161,0.32298136645962733
YDR186C,4,835546,836246,700,0.45571428571428574
CCT6,4,835672,836372,700,0.45571428571428574
SLY1,4,838223,838349,126,0.35714285714285715
RVB1,4,842041,842299,258,0.3488372093023256
HST4,4,842040,842298,258,0.3488372093023256
NUP42,4,844919,845619,700,0.34285714285714286
MSS116,4,847970,848360,390,0.36666666666666664
REF2,4,847969,848359,390,0.36923076923076925
CAB5,4,851018,851195,177,0.3163841807909605
CBS2,4,851017,851194,177,0.3163841807909605
RKM2,4,853997,854143,146,0.2945205479452055
VPS64,4,856158,856304,146,0.3424657534246575
SPC19,4,856157,856303,146,0.3424657534246575
RAV2,4,857984,858118,134,0.3358208955223881
COQ4,4,857983,858117,134,0.3358208955223881
MSC2,4,859275,859335,60,0.4166666666666667
EBS1,4,861616,861718,102,0.37254901960784315
UME6,4,867724,868085,361,0.43490304709141275
MSS4,4,867723,868084,361,0.4376731301939058
YDR210W,4,870696,871057,361,0.3961218836565097
GCD6,4,883975,884675,700,0.33285714285714285
TCP1,4,887019,887166,147,0.3401360544217687
UPC2,4,888998,889536,538,0.42193308550185876
AHA1,4,892531,892758,227,0.2687224669603524
ADR1,4,894022,894512,490,0.5326530612244897
RAD9,4,903541,904241,700,0.34
MFB1,4,907059,907317,258,0.38372093023255816
GTB1,4,907058,907316,258,0.38372093023255816
YDR222W,4,909607,910017,410,0.36829268292682926
CRF1,4,911451,911982,531,0.3804143126177024
HTB1,4,914751,915451,700,0.38571428571428573
HTA1,4,914754,915454,700,0.3871428571428571
ADK1,4,916096,916439,343,0.3877551020408163
SIR4,4,917280,917443,163,0.31901840490797545
PCF11,4,923897,924597,700,0.37142857142857144
IVY1,4,923983,924683,700,0.37857142857142856
COX20,4,926935,927201,266,0.49624060150375937
HEM1,4,926934,927200,266,0.5
RTN1,4,930416,931077,661,0.3888048411497731
LYS4,4,930415,931076,661,0.3888048411497731
PRP42,4,933311,933480,169,0.3668639053254438
FMN1,4,935917,936476,559,0.3828264758497317
MRPL7,4,935916,936475,559,0.3828264758497317
YDR239C,4,943432,943615,183,0.36065573770491804
SNU56,4,945172,945872,700,0.3057142857142857
TRS23,4,954127,954252,125,0.4
VHS1,4,955100,955722,622,0.4565916398713826
YDR248C,4,958405,958565,160,0.3
YDR249C,4,959860,960308,448,0.37723214285714285
PAM1,4,959859,960307,448,0.37723214285714285
BTT1,4,963240,963403,163,0.3006134969325153
MET32,4,964768,965034,266,0.3082706766917293
CHL4,4,964767,965033,266,0.3082706766917293
RMD5,4,967867,967989,122,0.3770491803278688
CTA1,4,969677,970377,700,0.37714285714285717
RKM4,4,971488,971702,214,0.32710280373831774
HSP78,4,974272,974496,224,0.36607142857142855
YAP6,4,976237,976373,136,0.34558823529411764
SWM1,4,977269,977400,131,0.3511450381679389
EXG2,4,979253,979953,700,0.33
YDR262W,4,992422,993122,700,0.3385714285714286
DIN7,4,995773,996473,700,0.3757142857142857
AKR1,4,998384,998740,356,0.398876404494382
PEX10,4,998383,998739,356,0.3960674157303371
YDR266C,4,1002237,1002364,127,0.28346456692913385
CIA1,4,1003562,1003953,391,0.340153452685422
MSW1,4,1003561,1003952,391,0.340153452685422
CCC2,4,1005245,1005587,342,0.4473684210526316
GLO2,4,1008952,1008958,6,0.16666666666666666
DON1,4,1008766,1008952,186,0.2903225806451613
BSC2,4,1011305,1011578,273,0.43223443223443225
PMP3,4,1013680,1014200,520,0.4634615384615385
MTH1,4,1015860,1016560,700,0.39
RNH202,4,1018589,1019289,700,0.3457142857142857
RRP45,4,1020446,1020658,212,0.3443396226415094
PHM6,4,1022376,1023076,700,0.3757142857142857
YDR282C,4,1024762,1024949,187,0.34759358288770054
GCN2,4,1030285,1030470,185,0.34594594594594597
DPP1,4,1031700,1032400,700,0.3485714285714286
ZIP1,4,1032692,1033392,700,0.3385714285714286
YDR286C,4,1035581,1035953,372,0.3467741935483871
INM2,4,1035580,1035952,372,0.34408602150537637
NSE3,4,1036958,1037179,221,0.4117647058823529
RTT103,4,1039564,1039721,157,0.25477707006369427
HRQ1,4,1039563,1039720,157,0.25477707006369427
SRP101,4,1045143,1045405,262,0.3015267175572519
SSD1,4,1050245,1050408,163,0.44171779141104295
DPL1,4,1052266,1052542,276,0.358695652173913
HDA2,4,1054910,1055159,249,0.3654618473895582
MHR1,4,1054909,1055158,249,0.3614457831325301
SUR2,4,1055978,1056509,531,0.4293785310734463
ATP5,4,1058968,1059577,609,0.367816091954023
BFR2,4,1058967,1059576,609,0.367816091954023
PRO1,4,1062847,1063296,449,0.3674832962138085
CFT1,4,1062846,1063295,449,0.36525612472160357
GPI11,4,1067554,1067687,133,0.3458646616541353
RSC3,4,1071678,1071808,130,0.4307692307692308
CPR5,4,1072587,1072681,94,0.3829787234042553
HNT2,4,1074108,1074808,700,0.33
YDR306C,4,1075223,1075806,583,0.3704974271012007
YDR307W,4,1075222,1075805,583,0.3704974271012007
SRB7,4,1078490,1079031,541,0.28650646950092423
GIC2,4,1080249,1080934,685,0.43795620437956206
SUM1,4,1084594,1085040,446,0.3632286995515695
TFB1,4,1084593,1085039,446,0.3632286995515695
SSF2,4,1087094,1087548,454,0.3744493392070485
PIB1,4,1090167,1090326,159,0.4339622641509434
RAD34,4,1092563,1092606,43,0.46511627906976744
IPK1,4,1093633,1093740,107,0.37383177570093457
OMS1,4,1093632,1093739,107,0.37383177570093457
HIM1,4,1101432,1102132,700,0.2785714285714286
MCM21,4,1103508,1103741,233,0.33476394849785407
YDR319C,4,1105906,1106004,98,0.2653061224489796
SWA2,4,1108126,1108201,75,0.44
ASP1,4,1108520,1108670,150,0.35333333333333333
MRPL35,4,1109956,1110562,606,0.2722772277227723
PEP7,4,1114057,1114252,195,0.3641025641025641
UTP4,4,1116732,1117114,382,0.3481675392670157
YCG1,4,1116731,1117113,382,0.34554973821989526
YSP2,4,1125118,1125241,123,0.36585365853658536
SKP1,4,1126085,1126197,112,0.42857142857142855
PEX3,4,1127621,1127813,192,0.359375
UBX5,4,1127620,1127812,192,0.359375
GPI8,4,1128866,1129566,700,0.39
IRC3,4,1130951,1130975,24,0.375
YDR333C,4,1135465,1135730,265,0.35094339622641507
SWR1,4,1135464,1135729,265,0.35094339622641507
MSN5,4,1140513,1140810,297,0.3939393939393939
YDR336W,4,1144931,1145074,143,0.3076923076923077
MRPS28,4,1146096,1146269,173,0.37572254335260113
YDR338C,4,1149525,1149862,337,0.3590504451038576
FCF1,4,1150541,1151241,700,0.3342857142857143
YDR341C,4,1153647,1154065,418,0.3444976076555024
HXT7,4,1156019,1156719,700,0.3914285714285714
HXT3,4,1164692,1165392,700,0.4014285714285714
SVF1,4,1168816,1169114,298,0.40604026845637586
MRP1,4,1168815,1169113,298,0.40604026845637586
YDR348C,4,1172024,1172264,240,0.39166666666666666
YPS7,4,1174276,1174976,700,0.3357142857142857
ATP22,4,1178202,1178444,242,0.3512396694214876
SBE2,4,1178201,1178443,242,0.34710743801652894
YDR352W,4,1181403,1181622,219,0.3607305936073059
TRR1,4,1182990,1183250,260,0.4307692307692308
TRP4,4,1184336,1184670,334,0.3413173652694611
SPC110,4,1185957,1186079,122,0.32786885245901637
CNL1,4,1189657,1190007,350,0.3028571428571429
GGA1,4,1189656,1190006,350,0.3028571428571429
EAF1,4,1195150,1195161,11,0.45454545454545453
BCP1,4,1196295,1196628,333,0.30930930930930933
TFC6,4,1198801,1199007,206,0.3932038834951456
ESC2,4,1198800,1199006,206,0.3932038834951456
CDC40,4,1204233,1204410,177,0.3220338983050847
ESF1,4,1206447,1207147,700,0.3485714285714286
KEI1,4,1212101,1212801,700,0.3
YPR1,4,1213653,1213852,199,0.31155778894472363
XRS2,4,1217612,1217730,118,0.3050847457627119
YDR370C,4,1219120,1219353,233,0.3605150214592275
CTS2,4,1219119,1219352,233,0.3605150214592275
VPS74,4,1222423,1222685,262,0.3282442748091603
FRQ1,4,1222422,1222684,262,0.3320610687022901
BCS1,4,1226557,1226759,202,0.36633663366336633
ARH1,4,1226556,1226758,202,0.3712871287128713
ATP17,4,1228374,1228540,166,0.40963855421686746
LSM6,4,1229627,1230091,464,0.36853448275862066
RGA2,4,1229626,1230090,464,0.36853448275862066
ARO10,4,1233539,1234114,575,0.3791304347826087
YRA1,4,1236252,1236474,222,0.4144144144144144
RPP2B,4,1238850,1239410,560,0.3357142857142857
NKP1,4,1240695,1241043,348,0.3132183908045977
ATO3,4,1242108,1242808,700,0.4257142857142857
EFT2,4,1242493,1243193,700,0.3842857142857143
MUS81,4,1245919,1246062,143,0.3986013986013986
YDR387C,4,1249967,1250135,168,0.36904761904761907
RVS167,4,1249966,1250134,168,0.3630952380952381
SAC7,4,1251754,1252020,266,0.4774436090225564
UBA2,4,1256876,1257277,401,0.3640897755610973
YDR391C,4,1258067,1258653,586,0.40102389078498296
SPT3,4,1258066,1258652,586,0.3993174061433447
SHE9,4,1259838,1259874,36,0.4166666666666667
RPT3,4,1261436,1261587,151,0.40397350993377484
SXM1,4,1263053,1263207,154,0.36363636363636365
NCB2,4,1266962,1267414,452,0.4004424778761062
UTP5,4,1266961,1267413,452,0.4004424778761062
HPT1,4,1269507,1269998,491,0.3564154786150713
URH1,4,1270838,1271035,197,0.4365482233502538
DIT1,4,1274688,1275388,700,0.35285714285714287
RPB7,4,1277361,1277593,232,0.3577586206896552
MRP20,4,1277360,1277592,232,0.3577586206896552
TRS120,4,1288017,1288043,26,0.2692307692307692
ADE8,4,1288905,1289381,476,0.36554621848739494
SIZ1,4,1288904,1289380,476,0.36554621848739494
STE14,4,1293139,1293305,166,0.3253012048192771
DFM1,4,1294444,1294644,200,0.36
RRP17,4,1294443,1294643,200,0.355
ERD1,4,1296883,1296943,60,0.2833333333333333
YDR415C,4,1298215,1298361,146,0.2945205479452055
SYF1,4,1298214,1298360,146,0.3013698630136986
RPL12B,4,1301042,1301581,539,0.4044526901669759
RAD30,4,1302468,1303168,700,0.30142857142857143
HKR1,4,1305406,1305892,486,0.3395061728395062
ARO80,4,1311756,1311974,218,0.28440366972477066
SIP1,4,1317829,1317993,164,0.3353658536585366
CAD1,4,1319241,1319338,97,0.3917525773195876
DYN2,4,1319867,1319981,114,0.42105263157894735
SNX41,4,1319866,1319980,114,0.42105263157894735
RPN9,4,1321956,1322172,216,0.3194444444444444
BNA7,4,1324272,1324360,88,0.3181818181818182
TIF35,4,1325319,1325444,125,0.376
CYM1,4,1328552,1328755,203,0.30049261083743845
NPL3,4,1328551,1328754,203,0.30049261083743845
YDR433W,4,1328551,1328754,203,0.30049261083743845
GPI17,4,1330440,1331140,700,0.32142857142857145
PPM1,4,1333981,1334681,700,0.46285714285714286
PPZ2,4,1333988,1334688,700,0.4614285714285714
GPI19,4,1337113,1337284,171,0.3742690058479532
THI74,4,1337113,1337284,171,0.3742690058479532
LRS4,4,1339480,1339588,108,0.2777777777777778
DOT1,4,1341705,1342405,700,0.37285714285714283
APT2,4,1345201,1345377,176,0.3068181818181818
YDR442W,4,1345376,1345632,256,0.47265625
SSN2,4,1350025,1350205,180,0.37222222222222223
YDR444W,4,1350024,1350204,180,0.37222222222222223
RPS17B,4,1355583,1355973,390,0.3769230769230769
ADA2,4,1355582,1355972,390,0.3769230769230769
UTP6,4,1358943,1359643,700,0.33714285714285713
RPS18A,4,1359201,1359901,700,0.37
YHP1,4,1362234,1362740,506,0.4031620553359684
PPN1,4,1362233,1362739,506,0.4031620553359684
TSA2,4,1365730,1366161,431,0.4037122969837587
GUK1,4,1366843,1367435,592,0.36824324324324326
NHX1,4,1366842,1367434,592,0.36655405405405406
TOM1,4,1369491,1369660,169,0.3609467455621302
HEH2,4,1382080,1382152,72,0.2916666666666667
PFA5,4,1383545,1383671,126,0.3333333333333333
TFB3,4,1383670,1383690,20,0.45
MFA1,4,1383544,1383670,126,0.3412698412698413
MRPL28,4,1385787,1386020,233,0.41630901287553645
STP1,4,1386643,1386775,132,0.3484848484848485
SPP41,4,1388577,1388748,171,0.2807017543859649
RMT2,4,1394617,1395026,409,0.38875305623471884
PKH3,4,1394616,1395025,409,0.38875305623471884
YDR467C,4,1398643,1398794,151,0.33774834437086093
TLG1,4,1398794,1398975,181,0.3149171270718232
SDC1,4,1398793,1398974,181,0.32044198895027626
UGO1,4,1401305,1401745,440,0.3840909090909091
RPL27B,4,1401304,1401744,440,0.38181818181818183
TRS31,4,1402680,1403256,576,0.3194444444444444
PRP3,4,1405922,1406622,700,0.33714285714285713
JIP4,4,1410192,1410251,59,0.288135593220339
YDR476C,4,1411145,1411845,700,0.42428571428571427
SNF1,4,1411378,1412078,700,0.4257142857142857
SNM1,4,1414410,1414554,144,0.3194444444444444
PEX29,4,1416922,1417341,419,0.3532219570405728
DIG2,4,1416921,1417340,419,0.35083532219570407
PHO8,4,1420298,1420327,29,0.41379310344827586
CWC21,4,1420852,1421131,279,0.34050179211469533
KRE2,4,1420851,1421130,279,0.34050179211469533
VPS52,4,1422596,1422720,124,0.28225806451612906
VPS72,4,1427228,1427287,59,0.3389830508474576
VPS60,4,1428129,1428250,121,0.32231404958677684
RIB3,4,1429033,1429733,700,0.48857142857142855
PAC11,4,1430800,1430999,199,0.3316582914572864
SLD5,4,1430799,1430998,199,0.33668341708542715
PKH1,4,1434353,1434770,417,0.38369304556354916
IZH1,4,1434352,1434769,417,0.38369304556354916
MZM1,4,1435942,1436115,173,0.3179190751445087
RSM28,4,1436689,1436896,207,0.36231884057971014
VPS3,4,1441209,1441359,150,0.32
PUF6,4,1443431,1443604,173,0.3236994219653179
ITR1,4,1445542,1445793,251,0.4262948207171315
SEC20,4,1447029,1447729,700,0.36
LCD1,4,1447112,1447812,700,0.3585714285714286
RPL37B,4,1450874,1451236,362,0.34806629834254144
PLM2,4,1450873,1451235,362,0.34806629834254144
SAM2,4,1454512,1454834,322,0.38509316770186336
LPP1,4,1455931,1456085,154,0.3246753246753247
SPG3,4,1459451,1459494,43,0.3023255813953488
PSP1,4,1459494,1460194,700,0.46285714285714286
YDR506C,4,1461593,1462176,583,0.33104631217838765
GIN4,4,1465824,1466436,612,0.3415032679738562
GNP1,4,1468488,1469188,700,0.4
SMT3,4,1468635,1469335,700,0.43714285714285717
ACN9,4,1469846,1469991,145,0.4068965517241379
EMI1,4,1470833,1470995,162,0.4444444444444444
GRX2,4,1470832,1470994,162,0.4506172839506173
YDR514C,4,1473060,1473202,142,0.323943661971831
SLF1,4,1473059,1473201,142,0.31690140845070425
EMI2,4,1476528,1477166,638,0.46394984326018807
GRH1,4,1476527,1477165,638,0.46238244514106586
EUG1,4,1478459,1478582,123,0.34959349593495936
FPR2,4,1480210,1480416,206,0.35436893203883496
URC2,4,1483485,1484185,700,0.3342857142857143
SPS1,4,1487033,1487260,227,0.28634361233480177
AGE1,4,1489060,1489281,221,0.3031674208144796
RBA50,4,1490559,1491058,499,0.37074148296593185
HLR1,4,1493570,1494270,700,0.3657142857142857
QCR7,4,1496585,1496644,59,0.3220338983050847
APA2,4,1497775,1498182,407,0.36855036855036855
CAB1,4,1497774,1498181,407,0.371007371007371
KRE28,4,1500586,1501286,700,0.33285714285714285
HSP31,4,1502188,1502888,700,0.35428571428571426
YDR535C,4,1507627,1507950,323,0.4086687306501548
STL1,4,1507626,1507949,323,0.4086687306501548
PAD1,4,1510140,1510840,700,0.37714285714285717
FDC1,4,1511865,1512053,188,0.35638297872340424
IRC4,4,1517779,1518479,700,0.36142857142857143
YDR541C,4,1520881,1521581,700,0.34285714285714286
IRC22,5,151017,151717,700,0.3171428571428571
WBP1,5,150064,150204,140,0.34285714285714286
GIM4,5,148090,148164,74,0.2702702702702703
YEA4,5,146790,146917,127,0.33858267716535434
VAB2,5,146791,146918,127,0.33858267716535434
YEA6,5,144033,144293,260,0.3076923076923077
YEL007W,5,141260,141497,237,0.3881856540084388
YEL008W,5,140333,140399,66,0.2727272727272727
GCN4,5,140334,140400,66,0.2878787878787879
GLC3,5,132659,133088,429,0.44755244755244755
UBC8,5,131009,131676,667,0.3748125937031484
VAC8,5,128361,128575,214,0.308411214953271
EDC3,5,126400,126595,195,0.3384615384615385
NPP2,5,126401,126596,195,0.3333333333333333
GTT3,5,122963,123615,652,0.4340490797546012
EAF5,5,121324,121466,142,0.3873239436619718
MMS21,5,121325,121467,142,0.3873239436619718
URA3,5,115872,116133,261,0.36015325670498083
GEA2,5,111111,111336,225,0.3022222222222222
YEL023C,5,111112,111337,225,0.3022222222222222
RIP1,5,106932,107158,226,0.43805309734513276
YEL025C,5,106933,107159,226,0.4424778761061947
SNU13,5,101503,101852,349,0.2922636103151863
VMA3,5,100005,100705,700,0.32285714285714284
YEL028W,5,97860,98073,213,0.3333333333333333
BUD16,5,97861,98074,213,0.3286384976525822
ECM10,5,94006,94208,202,0.29207920792079206
SPF1,5,90035,90226,191,0.39790575916230364
MCM3,5,86267,86885,618,0.3737864077669903
HYP2,5,85439,85622,183,0.3989071038251366
ANP1,5,84697,85397,700,0.43714285714285717
RAD23,5,82762,82966,204,0.3431372549019608
UTR4,5,80148,80442,294,0.4557823129251701
CYC7,5,80149,80443,294,0.45918367346938777
UTR2,5,77584,78036,452,0.37168141592920356
YEF1,5,75470,75664,194,0.3917525773195876
GDA1,5,73439,73614,175,0.28
YEL043W,5,70370,70440,70,0.22857142857142856
IES6,5,69050,69750,700,0.4742857142857143
GLY1,5,68894,69594,700,0.46285714285714286
YEL047C,5,66821,67043,222,0.36486486486486486
TCA17,5,65178,65397,219,0.2511415525114155
PAU2,5,62672,63372,700,0.35285714285714287
RML2,5,60902,61602,700,0.33285714285714285
VMA8,5,58168,58330,162,0.35802469135802467
AFG1,5,56184,56535,351,0.33903133903133903
MAK10,5,56185,56536,351,0.33903133903133903
RPL12A,5,53245,53818,573,0.4293193717277487
POL5,5,51594,52294,700,0.3657142857142857
HAT2,5,46404,47104,700,0.3628571428571429
YEL057C,5,45853,46553,700,0.38
PCM1,5,42676,43225,549,0.43169398907103823
HHY1,5,42343,42461,118,0.3559322033898305
PRB1,5,42008,42344,336,0.5029761904761905
CIN8,5,39661,39805,144,0.4097222222222222
NPR2,5,33696,34393,697,0.34146341463414637
CAN1,5,33697,34394,697,0.34146341463414637
AVT2,5,31272,31403,131,0.3511450381679389
SIT1,5,27282,27625,343,0.41690962099125367
HPA3,5,26004,26643,639,0.41784037558685444
YEL067C,5,26933,27283,350,0.4542857142857143
YEL068C,5,26005,26644,639,0.41784037558685444
DLD3,5,15618,16318,700,0.38285714285714284
RMD6,5,12889,13589,700,0.38142857142857145
MNN1,5,152770,153470,700,0.4057142857142857
NOP16,5,156053,156753,700,0.29
PMI40,5,159149,159572,423,0.4160756501182033
FMP52,5,159148,159571,423,0.4160756501182033
YND1,5,159804,160504,700,0.43
NUG1,5,162560,162683,123,0.34959349593495936
PAC2,5,164344,164505,161,0.22981366459627328
SEC3,5,171886,172079,193,0.38341968911917096
NTF2,5,171885,172078,193,0.37823834196891193
YER010C,5,173361,174061,700,0.34
TIR1,5,174493,175193,700,0.41714285714285715
PRE1,5,177063,177763,700,0.40285714285714286
PRP22,5,178559,178817,258,0.3449612403100775
HEM14,5,182273,182545,272,0.3235294117647059
FAA2,5,184333,184518,185,0.4594594594594595
BIM1,5,187556,188256,700,0.38
AFG3,5,191884,192417,533,0.5384615384615384
SPC25,5,192679,193379,700,0.44285714285714284
ISC1,5,191883,192416,533,0.5365853658536586
GPA2,5,194590,195100,510,0.4137254901960784
RPN3,5,196687,196916,229,0.3537117903930131
SRB4,5,198644,198783,139,0.3669064748201439
PRO3,5,200973,201047,74,0.32432432432432434
YAT2,5,202004,202161,157,0.3057324840764331
GCD11,5,205025,205196,171,0.3567251461988304
CHO1,5,208505,208742,237,0.3670886075949367
GAL83,5,210315,210636,321,0.40186915887850466
MIG3,5,211941,212483,542,0.36900369003690037
SMB1,5,213243,213424,181,0.32044198895027626
CHZ1,5,213242,213423,181,0.32044198895027626
YPT31,5,214782,215004,222,0.3963963963963964
FIR1,5,214781,215003,222,0.4009009009009009
ZRG8,5,221502,221828,326,0.3895705521472393
YER034W,5,221501,221827,326,0.3895705521472393
EDC2,5,221863,222563,700,0.4642857142857143
ARB1,5,225229,225868,639,0.3302034428794992
PHM8,5,225228,225867,639,0.3317683881064163
KRE29,5,228262,228348,86,0.2558139534883721
HVG1,5,229498,229713,215,0.40930232558139534
GLN3,5,229497,229712,215,0.40930232558139534
YEN1,5,232246,232399,153,0.3137254901960784
MXR1,5,234907,234908,1,1.0
SAH1,5,237143,237445,302,0.36423841059602646
ERG28,5,238063,238142,79,0.2911392405063291
ACA1,5,241717,242417,700,0.3842857142857143
SPO73,5,242376,243076,700,0.41285714285714287
SAP1,5,246702,246861,159,0.3333333333333333
CAJ1,5,248234,248934,700,0.36142857142857143
TPA1,5,251333,251645,312,0.3557692307692308
RSM18,5,254434,254642,208,0.3076923076923077
JHD1,5,254433,254641,208,0.3125
HOM3,5,258038,258594,556,0.35431654676258995
PIC2,5,259737,260437,700,0.36
GIP2,5,264142,264808,666,0.4174174174174174
HIS1,5,265824,266391,567,0.36331569664902996
FCY2,5,268200,268900,700,0.3557142857142857
HMF1,5,271169,271736,567,0.36860670194003525
PET117,5,271168,271735,567,0.37037037037037035
PCL6,5,272206,272441,235,0.3659574468085106
FCY21,5,273957,274437,480,0.3458333333333333
CEM1,5,279666,279755,89,0.3146067415730337
HOR2,5,280810,281510,700,0.4257142857142857
THO1,5,280948,281648,700,0.44285714285714284
YER064C,5,284306,285006,700,0.40714285714285714
ICL1,5,287235,287935,700,0.35714285714285715
RRT13,5,288649,289349,700,0.3657142857142857
RGI1,5,291287,291987,700,0.38857142857142857
MOT2,5,292640,292966,326,0.3619631901840491
ARG5_6,5,294923,295345,422,0.35545023696682465
RNR1,5,298210,298910,700,0.36
YER071C,5,302336,302788,452,0.34292035398230086
VTC1,5,302335,302787,452,0.34292035398230086
ALD5,5,303339,303951,612,0.3758169934640523
RPS24A,5,305864,306296,432,0.41898148148148145
PTP3,5,311361,312061,700,0.46
YER076C,5,313638,314338,700,0.3242857142857143
YER077C,5,316561,316723,162,0.2962962962962963
ICP55,5,318541,318841,300,0.37333333333333335
YER079W,5,318540,318840,300,0.37666666666666665
AIM9,5,319677,319934,257,0.35019455252918286
SER3,5,321957,322657,700,0.3414285714285714
UTP7,5,325990,326131,141,0.3049645390070922
GET2,5,327049,327500,451,0.45454545454545453
YER085C,5,328218,328413,195,0.3230769230769231
ILV1,5,328217,328412,195,0.31794871794871793
AIM10,5,330345,330537,192,0.3125
DOT6,5,335277,335873,596,0.4966442953020134
PTC2,5,337657,337885,228,0.32894736842105265
TRP2,5,337656,337884,228,0.32894736842105265
MET6,5,342237,342846,609,0.39901477832512317
IES5,5,342236,342845,609,0.39901477832512317
TSC11,5,347672,347833,161,0.2981366459627329
PUP3,5,349436,349934,498,0.44779116465863456
RAD51,5,349435,349933,498,0.4457831325301205
SHC1,5,351413,351580,167,0.41916167664670656
UBP9,5,354583,355283,700,0.39285714285714285
PRS2,5,359092,359468,376,0.40691489361702127
UBC6,5,359091,359467,376,0.40425531914893614
AST2,5,361847,362547,700,0.4014285714285714
RPS8B,5,362392,363092,700,0.41
SSA4,5,363765,364401,636,0.3490566037735849
RTT105,5,366644,366783,139,0.39568345323741005
NUP157,5,372034,372734,700,0.31
GLE2,5,374732,374881,149,0.30201342281879195
FLO8,5,377793,378493,700,0.4328571428571429
KAP123,5,382215,382513,298,0.30201342281879195
SWI4,5,386193,386893,700,0.3442857142857143
LSM4,5,386443,387143,700,0.3457142857142857
TMN3,5,390140,390289,149,0.2751677852348993
BOI2,5,394025,394180,155,0.36774193548387096
SPR6,5,395088,395788,700,0.40714285714285714
SLX8,5,396272,396749,477,0.4109014675052411
RPL23B,5,396271,396748,477,0.4109014675052411
SHO1,5,399245,399398,153,0.38562091503267976
AVT6,5,400868,401101,233,0.40772532188841204
SCS2,5,400867,401100,233,0.40772532188841204
YER121W,5,401970,402196,226,0.2920353982300885
GLO3,5,404425,404625,200,0.3
YCK3,5,404424,404624,200,0.3
DSE1,5,409099,409696,597,0.35510887772194305
RSP5,5,409098,409695,597,0.35678391959798994
NSA2,5,414206,414464,258,0.3643410852713178
LCP5,5,414205,414463,258,0.3643410852713178
YER128W,5,415672,415853,181,0.3425414364640884
SAK1,5,416610,416772,162,0.36419753086419754
YER130C,5,422513,423213,700,0.43142857142857144
RPS26B,5,422835,423535,700,0.3871428571428571
PMD1,5,430897,431597,700,0.3485714285714286
GLC7,5,431725,432425,700,0.35285714285714287
YER134C,5,437843,438543,700,0.34285714285714286
GDI1,5,438820,439520,700,0.3757142857142857
YER137C,5,441839,442366,527,0.49335863377609107
RTR1,5,451354,451521,167,0.3473053892215569
YER140W,5,451353,451520,167,0.3473053892215569
COX15,5,452713,453413,700,0.37714285714285717
MAG1,5,456060,456279,219,0.3515981735159817
DDI1,5,456059,456278,219,0.3561643835616438
UBP5,5,460232,460398,166,0.39156626506024095
FTR1,5,461761,462461,700,0.46714285714285714
LSM5,5,461843,462543,700,0.4714285714285714
SCC4,5,464908,465110,202,0.3316831683168317
SPT15,5,464907,465109,202,0.3316831683168317
PEA2,5,467527,468227,700,0.4185714285714286
SPI1,5,467634,468334,700,0.4157142857142857
UBP3,5,472498,472605,107,0.3364485981308411
YER152C,5,474046,474746,700,0.56
PET122,5,474813,475000,187,0.48128342245989303
OXA1,5,474812,474999,187,0.48128342245989303
BEM2,5,483122,483212,90,0.43333333333333335
YER156C,5,484357,484768,411,0.3722627737226277
COG3,5,484356,484767,411,0.3722627737226277
YER158C,5,490858,491398,540,0.44074074074074077
BUR6,5,492141,492841,700,0.35714285714285715
SPT2,5,500395,500522,127,0.25984251968503935
RAD4,5,502929,502982,53,0.3584905660377358
YER163C,5,503790,504490,700,0.3985714285714286
CHD1,5,504393,505093,700,0.3557142857142857
PAB1,5,509893,510230,337,0.314540059347181
DNF1,5,512231,512381,150,0.29333333333333333
BCK2,5,517548,517925,377,0.3660477453580902
CCA1,5,522706,523134,428,0.36682242990654207
RPH1,5,522705,523133,428,0.36682242990654207
ADK2,5,525224,525924,700,0.4
RAD3,5,526268,526968,700,0.37714285714285717
BRR2,5,536090,536286,196,0.3010204081632653
RAD24,5,536089,536285,196,0.3010204081632653
GRX4,5,539297,539494,197,0.3553299492385787
TMT1,5,540382,541082,700,0.32285714285714284
ECM32,5,541574,541647,73,0.2876712328767123
BMH1,5,545168,545567,399,0.45363408521303256
PDA1,5,546443,546788,345,0.3565217391304348
DMC1,5,548212,548821,609,0.35139573070607555
ISC10,5,551146,551148,2,0.0
YER181C,5,552408,552490,82,0.36585365853658536
FMP10,5,552407,552489,82,0.36585365853658536
FAU1,5,553970,554670,700,0.36142857142857143
YER184C,5,559058,559310,252,0.42857142857142855
PUG1,5,559057,559309,252,0.42857142857142855
YER186C,5,562810,563510,700,0.33
YER187W,5,564858,565558,700,0.35285714285714287
YER188W,5,567195,567895,700,0.38571428571428573
DEG1,6,146949,147093,144,0.3472222222222222
SPB4,6,146950,147094,144,0.3541666666666667
MSH4,6,135842,136542,700,0.3442857142857143
VTC2,6,131197,131719,522,0.37547892720306514
SEC4,6,129989,130196,207,0.391304347826087
BLM10,6,123208,123349,141,0.41843971631205673
SMC1,6,118687,119387,700,0.31142857142857144
CDC4,6,115771,115952,181,0.39226519337016574
WWM1,6,115772,115953,181,0.3867403314917127
YFL012W,6,109962,110585,623,0.3306581059390048
IES1,6,109963,110586,623,0.3290529695024077
HSP12,6,106496,107196,700,0.44142857142857145
MDJ1,6,106317,107017,700,0.44
GNA1,6,104476,104598,122,0.30327868852459017
LPD1,6,103206,103678,472,0.3665254237288136
PAU5,6,99714,100414,700,0.38
GAT1,6,95227,95927,700,0.4657142857142857
FRS2,6,95056,95756,700,0.40714285714285714
BUD27,6,90750,90978,228,0.3991228070175439
EPL1,6,90751,90979,228,0.3991228070175439
BST1,6,87297,87471,174,0.3333333333333333
STE2,6,81926,82080,154,0.3051948051948052
GYP8,6,81927,82081,154,0.3116883116883117
CAF16,6,80235,80332,97,0.32989690721649484
CAK1,6,79215,79270,55,0.3090909090909091
AGX1,6,76560,76730,170,0.5058823529411764
HAC1,6,74646,75112,466,0.3497854077253219
RIM15,6,74647,75113,466,0.3497854077253219
YFL034W,6,64973,65306,333,0.32732732732732733
RPO41,6,57933,58545,612,0.3366013071895425
TUB2,6,56020,56270,250,0.396
YPT1,6,56021,56271,250,0.396
ACT1,6,54816,55256,440,0.36818181818181817
FET5,6,48985,49116,131,0.3282442748091603
YFL042C,6,47768,47890,122,0.4344262295081967
OTU1,6,45579,45630,51,0.27450980392156865
SEC53,6,44467,45167,700,0.39714285714285713
FMP32,6,42637,42791,154,0.2727272727272727
RGD2,6,40201,40412,211,0.26540284360189575
EMP47,6,40202,40413,211,0.26540284360189575
SWP82,6,36630,36771,141,0.28368794326241137
ALR2,6,36631,36772,141,0.2765957446808511
YFL052W,6,27506,28206,700,0.40714285714285714
YFL054C,6,22852,23552,700,0.37857142857142856
AGP3,6,16116,16680,564,0.35815602836879434
AAD6,6,16117,16681,564,0.3599290780141844
AAD16,6,16117,16681,564,0.3599290780141844
LOC1,6,148492,149077,585,0.2564102564102564
NIC96,6,149798,149999,201,0.3283582089552239
YPI1,6,153179,153347,168,0.39285714285714285
RPN11,6,153178,153346,168,0.39285714285714285
SAD1,6,155893,156120,227,0.3788546255506608
YFR006W,6,155892,156119,227,0.3788546255506608
YFH7,6,158578,159278,700,0.34285714285714286
FAR7,6,160425,160491,66,0.4090909090909091
GCN20,6,161730,162430,700,0.32
UBP6,6,164812,164998,186,0.3225806451612903
AIM13,6,167290,167977,687,0.2954876273653566
IOC3,6,169542,169865,323,0.34674922600619196
CMK1,6,173927,174126,199,0.4120603015075377
GSY1,6,176479,176999,520,0.4596153846153846
YFR016C,6,180780,181480,700,0.36142857142857143
YFR017C,6,182974,183674,700,0.5042857142857143
YFR018C,6,184275,184493,218,0.43119266055045874
FAB1,6,184274,184492,218,0.43577981651376146
YFR020W,6,191567,192267,700,0.3742857142857143
ATG18,6,194017,194717,700,0.37
ROG3,6,196420,196545,125,0.312
PES4,6,199592,200292,700,0.33285714285714285
HIS2,6,204774,205474,700,0.35428571428571426
ULI1,6,207241,207435,194,0.37628865979381443
ECO1,6,207240,207434,194,0.37628865979381443
CDC14,6,210126,210826,700,0.37142857142857144
PTR3,6,210172,210872,700,0.3757142857142857
MET10,6,213044,213225,181,0.44751381215469616
SMC2,6,220145,220437,292,0.3561643835616438
QCR6,6,224875,225575,700,0.5714285714285714
PHO4,6,225985,225993,8,0.5
YFR035C,6,226465,226599,134,0.3880597014925373
CDC26,6,226598,226940,342,0.3742690058479532
RSC8,6,229216,229362,146,0.3424657534246575
IRC5,6,229215,229361,146,0.3493150684931507
YFR039C,6,233673,233942,269,0.3271375464684015
SAP155,6,233672,233941,269,0.32342007434944237
ERJ5,6,238278,238413,135,0.23703703703703705
KEG1,6,238277,238412,135,0.23703703703703705
IRC6,6,239858,239923,65,0.3384615384615385
DUG1,6,241455,241934,479,0.3465553235908142
YFR045W,6,241454,241933,479,0.3465553235908142
CNN1,6,244160,244198,38,0.34210526315789475
BNA6,6,245192,245892,700,0.37714285714285717
RMD8,6,245393,246093,700,0.35285714285714287
YMR31,6,248176,248360,184,0.3423913043478261
PRE4,6,249919,250086,167,0.32335329341317365
RET2,6,251828,252478,650,0.38769230769230767
RPN12,6,251827,252477,650,0.38769230769230767
HXK1,6,255153,255853,700,0.4114285714285714
IRC7,6,263469,264169,700,0.35714285714285715
ERG26,7,496566,497056,490,0.25918367346938775
ERP6,7,494276,494491,215,0.39069767441860465
CDH1,7,494277,494492,215,0.39069767441860465
RPN14,7,491960,492285,325,0.3415384615384615
COG7,7,490576,490659,83,0.3493975903614458
BRP1,7,482901,483222,321,0.3364485981308411
PMA1,7,482902,483223,321,0.3364485981308411
LEU1,7,478723,479418,695,0.381294964028777
YGL010W,7,475271,475487,216,0.3888888888888889
SCL1,7,475272,475488,216,0.3888888888888889
ERG4,7,472441,472817,376,0.3962765957446808
PDR1,7,472442,472818,376,0.3962765957446808
PUF4,7,465093,465719,626,0.35782747603833864
KAP122,7,461439,461609,170,0.3176470588235294
ATE1,7,459698,459833,135,0.3111111111111111
JAC1,7,459699,459834,135,0.3111111111111111
CKB1,7,457929,458079,150,0.36666666666666664
GET1,7,457930,458080,150,0.36666666666666664
ALK1,7,454641,454829,188,0.28191489361702127
STT3,7,452144,452338,194,0.42783505154639173
PIB2,7,452145,452339,194,0.42783505154639173
PGD1,7,449994,450069,75,0.41333333333333333
TRP5,7,448553,448706,153,0.3137254901960784
CWH41,7,446156,446330,174,0.3505747126436782
SCW11,7,443076,443550,474,0.36075949367088606
CGR1,7,439738,440020,282,0.3617021276595745
RPL30,7,438437,439032,595,0.4050420168067227
RPL24A,7,438438,439033,595,0.4050420168067227
AGA2,7,436969,437355,386,0.3393782383419689
MIG1,7,433178,433878,700,0.43
YGL036W,7,428034,428525,491,0.35845213849287166
PNC1,7,428035,428526,491,0.3564154786150713
OCH1,7,426852,427154,302,0.4205298013245033
YGL039W,7,423145,423845,700,0.3628571428571429
HEM2,7,420631,421331,700,0.3628571428571429
YGL041C,7,419246,419318,72,0.4027777777777778
DST1,7,417261,417460,199,0.3768844221105528
RNA15,7,417262,417461,199,0.3768844221105528
RIM8,7,413093,413793,700,0.4614285714285714
ALG13,7,411313,411468,155,0.32903225806451614
RPT6,7,411314,411469,155,0.33548387096774196
TIF4632,7,409774,409973,199,0.39195979899497485
TYW3,7,405049,405749,700,0.3514285714285714
PRM8,7,401789,402489,700,0.3242857142857143
ERV14,7,401349,402049,700,0.3357142857142857
OLE1,7,397865,398565,700,0.45714285714285713
SDS23,7,397716,398416,700,0.44571428571428573
GEP7,7,395848,395956,108,0.3055555555555556
RAD6,7,393846,393925,79,0.3291139240506329
PKP2,7,392078,392187,109,0.3944954128440367
YBP2,7,389783,389934,151,0.3443708609271523
DUO1,7,389784,389935,151,0.3443708609271523
PYC1,7,384454,385154,700,0.5028571428571429
PUS2,7,383211,383459,248,0.3185483870967742
MRH4,7,383212,383460,248,0.3185483870967742
ALG2,7,381316,381468,152,0.3355263157894737
SGF73,7,377292,377417,125,0.336
NPY1,7,375780,376017,237,0.3291139240506329
MNP1,7,374851,375039,188,0.3776595744680851
RPB9,7,374852,375040,188,0.3776595744680851
AFT1,7,371310,371553,243,0.5061728395061729
HSF1,7,368397,368676,279,0.3763440860215054
MPS2,7,368398,368677,279,0.3763440860215054
RPL7A,7,366018,366689,671,0.3323397913561848
HNM1,7,364053,364226,173,0.3179190751445087
DBP3,7,361929,362141,212,0.32075471698113206
KXD1,7,359288,359410,122,0.3114754098360656
FMP37,7,357899,358599,700,0.4014285714285714
YGL081W,7,357108,357276,168,0.3392857142857143
YGL082W,7,355613,355736,123,0.42276422764227645
SCY1,7,352349,352989,640,0.325
GUP1,7,352350,352990,640,0.325
LCL3,7,349439,349574,135,0.25925925925925924
MAD1,7,346939,347167,228,0.3508771929824561
MMS2,7,346940,347168,228,0.35526315789473684
MF(ALPHA)2,7,344964,345259,295,0.39322033898305087
LIF1,7,343089,343286,197,0.3299492385786802
NBP35,7,343090,343287,197,0.3350253807106599
NUP145,7,337676,337807,131,0.33587786259541985
SPC105,7,334659,334814,155,0.3419354838709677
PAN2,7,334660,334815,155,0.33548387096774196
VPS45,7,330674,330972,298,0.39932885906040266
TOS8,7,324554,325254,700,0.41714285714285715
SRM1,7,321034,321734,700,0.3742857142857143
USE1,7,316602,317291,689,0.3555878084179971
LSG1,7,314370,314601,231,0.2987012987012987
SEH1,7,313086,313205,119,0.31932773109243695
YGL101W,7,312012,312164,152,0.3223684210526316
RPL28,7,310250,310950,700,0.3457142857142857
VPS73,7,310178,310878,700,0.3457142857142857
ARC1,7,307143,307413,270,0.28888888888888886
MLC1,7,306289,306537,248,0.3790322580645161
RMD9,7,306290,306538,248,0.3790322580645161
YGL108C,7,304106,304219,113,0.3185840707964602
CUE3,7,303424,303444,20,0.25
NSA1,7,299763,299933,170,0.34705882352941175
TAF6,7,299764,299934,170,0.3411764705882353
SLD3,7,295699,295901,202,0.35148514851485146
YGL114W,7,293086,293217,131,0.3893129770992366
SNF4,7,291738,291911,173,0.35260115606936415
CDC20,7,289394,289662,268,0.3582089552238806
YGL117W,7,287731,288431,700,0.34285714285714286
COQ8,7,283975,284389,414,0.32608695652173914
PRP43,7,283976,284390,414,0.32608695652173914
GPG1,7,281262,281621,359,0.3342618384401114
NAB2,7,280532,280631,99,0.2727272727272727
RPS2,7,276865,277565,700,0.37
MON1,7,276745,277445,700,0.37142857142857144
MET13,7,272276,272380,104,0.15384615384615385
SCS3,7,270818,270932,114,0.3333333333333333
SOH1,7,270819,270933,114,0.3333333333333333
CWC23,7,270150,270245,95,0.4105263157894737
RSM23,7,269146,269846,700,0.38857142857142857
CEG1,7,265929,266098,169,0.31952662721893493
SNT2,7,265930,266099,169,0.31952662721893493
PCL10,7,255390,255565,175,0.38857142857142857
RPL1B,7,253882,254576,694,0.36023054755043227
MRM2,7,253883,254577,694,0.36023054755043227
SEC27,7,249144,249844,700,0.34
FLC3,7,245193,245401,208,0.3942307692307692
YGL140C,7,245194,245402,208,0.3894230769230769
HUL5,7,238172,238312,140,0.37857142857142856
GPI10,7,238173,238313,140,0.37857142857142856
MRF1,7,235989,236129,140,0.37142857142857144
ROG1,7,234549,234586,37,0.35135135135135137
TIP20,7,229726,230186,460,0.34130434782608693
RRT6,7,229727,230187,460,0.34130434782608693
RPL9A,7,228346,229046,700,0.37285714285714283
ARO2,7,226257,226366,109,0.3853211009174312
INO80,7,226258,226367,109,0.3944954128440367
NUT1,7,217335,217478,143,0.32867132867132864
PEX14,7,216111,216247,136,0.3014705882352941
LYS5,7,216112,216248,136,0.3014705882352941
CDC43,7,213797,213976,179,0.329608938547486
AMS1,7,210140,210333,193,0.39896373056994816
ARI1,7,208695,208956,261,0.37547892720306514
RCK1,7,205944,206644,700,0.3457142857142857
YGL159W,7,202406,202713,307,0.3745928338762215
AIM14,7,200222,200447,225,0.4088888888888889
YIP5,7,200223,200448,225,0.4088888888888889
SUT1,7,197290,197990,700,0.43857142857142856
RAD54,7,196525,197225,700,0.41
YRB30,7,193320,193572,252,0.3134920634920635
CUP2,7,190843,191107,264,0.49242424242424243
PMR1,7,190844,191108,264,0.4962121212121212
SUA5,7,185299,185999,700,0.3457142857142857
ROK1,7,182216,182361,145,0.35172413793103446
NUP49,7,180512,180667,155,0.38064516129032255
KEM1,7,180513,180668,155,0.3741935483870968
BUD13,7,174344,174527,183,0.33879781420765026
SAE2,7,174345,174528,183,0.3333333333333333
YGL176C,7,173124,173193,69,0.2898550724637681
TOS3,7,165181,165881,700,0.4185714285714286
ATG1,7,159203,159501,298,0.42953020134228187
GTS1,7,157154,157854,700,0.3871428571428571
STR3,7,156449,157149,700,0.3414285714285714
YGL185C,7,154315,154657,342,0.35964912280701755
TPN1,7,152809,153087,278,0.37050359712230213
COX4,7,150634,150995,361,0.3656509695290859
RPS26A,7,148611,148997,386,0.3238341968911917
CDC55,7,147934,148160,226,0.27876106194690264
COX13,7,144488,144763,275,0.39636363636363636
IME4,7,141984,142177,193,0.41450777202072536
YGL193C,7,144489,144764,275,0.3927272727272727
HOS2,7,141793,141985,192,0.3854166666666667
GCN1,7,131278,131492,214,0.3177570093457944
DSD1,7,129733,129817,84,0.27380952380952384
MDS3,7,124338,124365,27,0.5925925925925926
YIP4,7,123348,123583,235,0.37446808510638296
EMP24,7,123349,123584,235,0.37446808510638296
MCM6,7,120974,121674,700,0.35714285714285715
ARO8,7,115235,115935,700,0.3557142857142857
KEX1,7,114741,115441,700,0.33
YGL204C,7,112121,112407,286,0.27972027972027974
POX1,7,107618,107974,356,0.34831460674157305
CHC1,7,107619,107975,356,0.34831460674157305
SPT16,7,98713,98875,162,0.35185185185185186
SIP2,7,97120,97319,199,0.3969849246231156
MIG2,7,95110,95810,700,0.42
YPT32,7,93700,93759,59,0.5084745762711864
NCS6,7,91788,92488,700,0.44571428571428573
VAM7,7,91263,91406,143,0.23076923076923078
SKI8,7,91264,91407,143,0.23076923076923078
CLG1,7,87348,87508,160,0.28125
KIP3,7,84283,84617,334,0.31736526946107785
MDM34,7,84284,84618,334,0.31736526946107785
FRA2,7,81328,81431,103,0.3592233009708738
NIF3,7,82311,82794,483,0.40372670807453415
EDC1,7,81231,81329,98,0.35714285714285715
COG1,7,80399,80791,392,0.3239795918367347
SDT1,7,78956,79095,139,0.2589928057553957
VRG4,7,76152,76852,700,0.36857142857142855
OST5,7,73198,73335,137,0.3357664233576642
MTC3,7,73197,73334,137,0.3357664233576642
VID30,7,69482,69628,146,0.4178082191780822
SHE10,7,67187,67554,367,0.3651226158038147
SAP4,7,67188,67555,367,0.3678474114441417
YGL230C,7,64382,65082,700,0.33714285714285713
EMC4,7,63631,63814,183,0.273224043715847
TAN1,7,61918,62052,134,0.23880597014925373
SEC15,7,58993,59075,82,0.2926829268292683
ADE5_7,7,55811,56447,636,0.41823899371069184
MTO1,7,55812,56448,636,0.41823899371069184
HAP2,7,53612,53717,105,0.3904761904761905
CSE1,7,48840,49540,700,0.41
DOC1,7,48560,48576,16,0.375
KAP114,7,45251,45427,176,0.3465909090909091
YGL242C,7,45252,45428,176,0.3465909090909091
TAD1,7,43265,43272,7,0.14285714285714285
RTF1,7,41208,41422,214,0.3364485981308411
GUS1,7,38808,39007,199,0.31155778894472363
RAI1,7,38809,39008,199,0.3065326633165829
BRR6,7,36826,36912,86,0.3023255813953488
PDE1,7,35336,35523,187,0.3422459893048128
ZIP2,7,33268,33968,700,0.36857142857142855
RMR1,7,31205,31905,700,0.3485714285714286
HFM1,7,30269,30969,700,0.3357142857142857
RTG2,7,27522,27749,227,0.3568281938325991
HXK2,7,23187,23887,700,0.3985714285714286
FZF1,7,22203,22286,83,0.3855421686746988
ZRT1,7,20232,20932,700,0.4085714285714286
ADH4,7,14265,14656,391,0.37595907928388744
MNT2,7,14266,14657,391,0.37595907928388744
VEL1,7,10076,10442,366,0.3551912568306011
YPS5,7,7514,8214,700,0.3742857142857143
COS12,7,2077,2777,700,0.27
YGR001C,7,498047,498201,154,0.2987012987012987
SWC4,7,499915,500104,189,0.328042328042328
CUL3,7,499914,500103,189,0.328042328042328
PEX31,7,502610,502877,267,0.32209737827715357
TFG2,7,505889,506061,172,0.36046511627906974
PRP18,7,505888,506060,172,0.3546511627906977
ECT1,7,506238,506938,700,0.3914285714285714
STF2,7,508451,508960,509,0.3850687622789784
SEC9,7,511045,511451,406,0.3669950738916256
NMA2,7,511044,511450,406,0.3669950738916256
YGR011W,7,511044,511450,406,0.3669950738916256
YGR012W,7,512936,513132,196,0.32142857142857145
SNU71,7,514389,514517,128,0.359375
MSB2,7,516649,516667,18,0.2222222222222222
YGR015C,7,522095,522243,148,0.3716216216216216
YGR016W,7,522094,522242,148,0.3783783783783784
YGR017W,7,523298,523627,329,0.3768996960486322
YGR018C,7,525511,526211,700,0.44142857142857145
UGA1,7,524793,525190,397,0.3954659949622166
VMA7,7,527393,527591,198,0.35858585858585856
YGR021W,7,527392,527590,198,0.35858585858585856
MTL1,7,528596,529111,515,0.4563106796116505
THG1,7,532643,532854,211,0.3744075829383886
YGR026W,7,532642,532853,211,0.3791469194312796
RPS25A,7,534829,535529,700,0.32285714285714284
MSP1,7,541352,542052,700,0.32
ERV1,7,543433,543523,90,0.3333333333333333
POP6,7,546172,546369,197,0.3604060913705584
YGR031W,7,546171,546368,197,0.3604060913705584
GSC2,7,547226,547926,700,0.47714285714285715
TIM21,7,555061,555761,700,0.3628571428571429
RPL26B,7,555081,555781,700,0.35714285714285715
YGR035C,7,557510,558210,700,0.39571428571428574
CAX4,7,559033,559550,517,0.36363636363636365
ACB1,7,560042,560544,502,0.4362549800796813
ORM1,7,560041,560543,502,0.4362549800796813
KSS1,7,574484,575184,700,0.30714285714285716
BUD9,7,577008,577174,166,0.28313253012048195
YGR042W,7,579249,579456,207,0.3864734299516908
NQM1,7,581427,582127,700,0.3657142857142857
RME1,7,583978,584678,700,0.39714285714285713
TAM41,7,584102,584802,700,0.3985714285714286
TFC4,7,589504,589771,267,0.3707865168539326
UFD1,7,589503,589770,267,0.37453183520599254
SCM4,7,590990,591264,274,0.34306569343065696
YGR050C,7,592519,593119,600,0.5083333333333333
FMP48,7,592518,593118,600,0.51
YGR053C,7,595940,596526,586,0.33447098976109213
YGR054W,7,595939,596525,586,0.33447098976109213
MUP1,7,598817,599383,566,0.4381625441696113
RSC1,7,601255,601612,357,0.33053221288515405
LST7,7,605564,606115,551,0.35571687840290384
PEF1,7,605563,606114,551,0.35571687840290384
SPR3,7,607440,607582,142,0.28169014084507044
ERG25,7,609789,610489,700,0.44142857142857145
ADE6,7,616010,616251,241,0.3360995850622407
COX18,7,617296,617384,88,0.32954545454545453
SPT4,7,617845,617982,137,0.36496350364963503
VHT1,7,619968,620668,700,0.38142857142857145
YGR067C,7,624851,624926,75,0.37333333333333335
ART5,7,627120,627775,655,0.29465648854961835
ROM1,7,627119,627774,655,0.2961832061068702
YGR071C,7,634082,634247,165,0.28484848484848485
UPF3,7,634081,634246,165,0.2787878787878788
YGR073C,7,636915,637006,91,0.3076923076923077
SMD1,7,635672,635696,24,0.3333333333333333
PRP38,7,636915,637006,91,0.3076923076923077
MRPL25,7,637633,637692,59,0.3220338983050847
PEX8,7,639539,639697,158,0.3037974683544304
PAC10,7,640404,640815,411,0.36739659367396593
YGR079W,7,640403,640814,411,0.36982968369829683
TWF1,7,641894,641991,97,0.27835051546391754
SLX9,7,643788,643997,209,0.3875598086124402
TOM20,7,643787,643996,209,0.3875598086124402
GCD2,7,648287,648294,7,0.42857142857142855
MRP13,7,648930,649336,406,0.3374384236453202
RPL11B,7,648930,649336,406,0.3374384236453202
PIL1,7,650706,651193,487,0.44763860369609854
PDC6,7,653013,653713,700,0.37
CTT1,7,653908,654608,700,0.44571428571428573
NNF2,7,656407,656688,281,0.33451957295373663
UTP22,7,661380,662080,700,0.37142857142857144
PRP31,7,666185,666271,86,0.38372093023255816
DBF2,7,667930,668126,196,0.32653061224489793
YGR093W,7,670056,670337,281,0.3487544483985765
VAS1,7,671991,672190,199,0.40703517587939697
RRP46,7,676412,676574,162,0.3148148148148148
TPC1,7,676411,676573,162,0.32098765432098764
ASK10,7,677754,678454,700,0.4114285714285714
ESP1,7,687707,687830,123,0.3333333333333333
TEL2,7,687706,687829,123,0.3333333333333333
MDR1,7,690027,690162,135,0.4074074074074074
PCP1,7,693224,693322,98,0.40816326530612246
YGR102C,7,695149,695389,240,0.3125
NOP7,7,695148,695388,240,0.3125
SRB5,7,698398,698547,149,0.26174496644295303
VMA21,7,698397,698546,149,0.26174496644295303
VOA1,7,699843,700543,700,0.33285714285714285
CLB1,7,702727,703427,700,0.39571428571428574
CLB6,7,706574,707274,700,0.37285714285714283
CLD1,7,712957,713657,700,0.3171428571428571
YGR111W,7,715141,715787,646,0.3204334365325077
SHY1,7,717148,717299,151,0.3708609271523179
DAM1,7,718735,718832,97,0.3711340206185567
SPT6,7,720221,720357,136,0.3235294117647059
YGR117C,7,726502,726951,449,0.41648106904231624
RPS23A,7,726501,726950,449,0.41648106904231624
NUP57,7,729760,729857,97,0.31958762886597936
COG2,7,730854,731309,455,0.34945054945054943
MEP1,7,732974,733246,272,0.34191176470588236
YGR122W,7,733629,733779,150,0.43333333333333335
PPT1,7,738250,738950,700,0.32
ASN2,7,739212,739912,700,0.4057142857142857
YGR125W,7,741773,742254,481,0.33264033264033266
YGR126W,7,745587,745740,153,0.3790849673202614
YGR127W,7,745740,745794,54,0.3888888888888889
UTP8,7,750129,750365,236,0.3305084745762712
SYF2,7,750128,750364,236,0.3305084745762712
YGR130C,7,753947,754647,700,0.43
FHN1,7,753946,754646,700,0.43
PHB1,7,756494,756934,440,0.38636363636363635
PEX4,7,756493,756933,440,0.38636363636363635
CAF130,7,757581,757617,36,0.19444444444444445
PRE9,7,761304,761318,14,0.42857142857142855
LSB1,7,762246,762410,164,0.42073170731707316
YGR137W,7,762246,762410,164,0.42073170731707316
TPO2,7,765886,766586,700,0.46
CBF2,7,766777,767477,700,0.35714285714285715
VPS62,7,770341,770548,207,0.3864734299516908
BTN2,7,771616,772316,700,0.41285714285714287
SKN1,7,774041,774741,700,0.3842857142857143
THI4,7,779465,780165,700,0.37
ENP2,7,781397,781711,314,0.27070063694267515
ECL1,7,785155,785545,390,0.3923076923076923
NAT2,7,786983,787175,192,0.375
RPL24B,7,788200,788900,700,0.3985714285714286
YGR149W,7,788219,788919,700,0.3871428571428571
CCM1,7,793063,793763,700,0.36428571428571427
YGR151C,7,795633,796071,438,0.3424657534246575
RSR1,7,795633,796071,438,0.3424657534246575
YGR153W,7,795632,796070,438,0.3424657534246575
GTO1,7,798140,798507,367,0.39509536784741145
CYS4,7,798139,798506,367,0.3978201634877384
PTI1,7,800205,800411,206,0.3883495145631068
CHO2,7,801914,802186,272,0.3713235294117647
MTR3,7,806071,806268,197,0.350253807106599
NSR1,7,807700,808400,700,0.3628571428571429
RTS3,7,809514,810184,670,0.4582089552238806
TIF4631,7,823297,823997,700,0.35285714285714287
GTR2,7,827333,827494,161,0.35403726708074534
MRPS35,7,828637,829061,424,0.3466981132075472
KRE11,7,830293,830432,139,0.2949640287769784
CLC1,7,832273,832391,118,0.3389830508474576
YGR168C,7,834523,834590,67,0.3582089552238806
PUS6,7,835929,836011,82,0.2682926829268293
PSD2,7,836727,837085,358,0.2988826815642458
MSM1,7,842574,842718,144,0.3263888888888889
YIP1,7,843621,843810,189,0.3492063492063492
RBG2,7,843620,843809,189,0.3492063492063492
CBP4,7,846370,846754,384,0.3307291666666667
ERG1,7,848450,848613,163,0.22085889570552147
ATF2,7,850499,850923,424,0.3231132075471698
PBP1,7,853428,853545,117,0.3247863247863248
OKP1,7,854918,855159,241,0.35269709543568467
RNR4,7,856476,857176,700,0.49142857142857144
TIM13,7,857537,858237,700,0.39
QCR9,7,859546,859890,344,0.35174418604651164
UBR1,7,866154,866242,88,0.42045454545454547
TYS1,7,867552,867756,204,0.3284313725490196
TFG1,7,867551,867755,204,0.3284313725490196
HGH1,7,871469,871972,503,0.32803180914512925
BUB1,7,875162,875862,700,0.32571428571428573
CRH1,7,878255,878955,700,0.36857142857142855
HIP1,7,879518,880218,700,0.3442857142857143
TDH3,7,883849,884405,556,0.3776978417266187
PDX1,7,885830,885970,140,0.37142857142857144
XKS1,7,888347,888762,415,0.2963855421686747
SKI6,7,888346,888761,415,0.2963855421686747
FYV8,7,892245,892428,183,0.3333333333333333
SNG1,7,894341,894636,295,0.39661016949152544
YPP1,7,894340,894635,295,0.39322033898305087
PMT6,7,897241,897460,219,0.2831050228310502
ELP2,7,902329,902461,132,0.3787878787878788
YGR201C,7,903210,903341,131,0.44274809160305345
PCT1,7,904774,905192,418,0.3492822966507177
YCH1,7,904773,905191,418,0.34688995215311
ADE3,7,905867,905894,27,0.4074074074074074
YGR205W,7,908862,909086,224,0.36160714285714285
MVB12,7,910209,910407,198,0.30303030303030304
YGR207C,7,911658,911838,180,0.2777777777777778
SER2,7,911657,911837,180,0.2833333333333333
TRX2,7,913278,913387,109,0.4036697247706422
YGR210C,7,914848,915179,331,0.3595166163141994
ZPR1,7,914847,915178,331,0.3595166163141994
SLI1,7,916899,917035,136,0.3235294117647059
RTA1,7,919469,919553,84,0.34523809523809523
RPS0A,7,919852,920552,700,0.4057142857142857
RSM27,7,921911,922123,212,0.33962264150943394
GPI1,7,924502,924656,154,0.3181818181818182
CCH1,7,924501,924655,154,0.3181818181818182
CRM1,7,931541,932241,700,0.3171428571428571
MRPL9,7,936893,937061,168,0.375
TOS2,7,939080,939780,700,0.36142857142857143
PET54,7,939218,939918,700,0.35428571428571426
HSV2,7,942261,942772,511,0.37181996086105673
AZR1,7,942260,942771,511,0.37181996086105673
AMA1,7,944867,945037,170,0.31176470588235294
DIE2,7,947137,947340,203,0.37438423645320196
SMI1,7,951175,951762,587,0.3594548551959114
BNS1,7,951174,951761,587,0.36115843270868825
PHB2,7,953553,953938,385,0.36363636363636365
NAS6,7,953552,953937,385,0.36363636363636365
PHO81,7,958422,959122,700,0.37
YHB1,7,959183,959883,700,0.3757142857142857
YGR235C,7,962116,962387,271,0.3247232472324723
SPG1,7,963217,963917,700,0.4
YGR237C,7,965743,965918,175,0.4228571428571429
KEL2,7,968695,969092,397,0.3904282115869018
PEX21,7,970087,970540,453,0.3841059602649007
PFK1,7,973968,974668,700,0.3242857142857143
YAP1802,7,976751,977245,494,0.4230769230769231
FMP43,7,976750,977244,494,0.4230769230769231
LSC2,7,979427,979707,280,0.40714285714285714
SDA1,7,982155,982317,162,0.30864197530864196
BRF1,7,984288,984817,529,0.3534971644612476
CPD1,7,984287,984816,529,0.3553875236294896
SOL4,7,985775,985953,178,0.3707865168539326
MGA1,7,986876,987576,700,0.4957142857142857
YGR250C,7,993768,994468,700,0.4185714285714286
YGR251W,7,994910,995610,700,0.36428571428571427
GCN5,7,996612,996820,208,0.2692307692307692
PUP2,7,999187,999887,700,0.2985714285714286
ENO1,7,1000189,1000889,700,0.43142857142857144
COQ6,7,1004055,1004566,511,0.37573385518590996
GND2,7,1004054,1004565,511,0.37377690802348335
MTM1,7,1007409,1007618,209,0.41148325358851673
RAD2,7,1010794,1011494,700,0.3985714285714286
TNA1,7,1011582,1012282,700,0.36714285714285716
APL6,7,1016787,1016870,83,0.2289156626506024
BUD32,7,1017788,1017889,101,0.37623762376237624
SAY1,7,1019275,1019406,131,0.3282442748091603
MES1,7,1021860,1022560,700,0.3514285714285714
YGR266W,7,1021899,1022599,700,0.36
FOL2,7,1025905,1026605,700,0.48142857142857143
HUA1,7,1026668,1027368,700,0.39714285714285713
SLH1,7,1031071,1031771,700,0.34714285714285714
TAF1,7,1043111,1043244,133,0.3157894736842105
RTT102,7,1043110,1043243,133,0.3157894736842105
RNH70,7,1045512,1045553,41,0.43902439024390244
CAB4,7,1046575,1046721,146,0.273972602739726
CWC22,7,1046574,1046720,146,0.273972602739726
SCW4,7,1050053,1050689,636,0.41509433962264153
PXR1,7,1051748,1052448,700,0.4042857142857143
YOR1,7,1051887,1052587,700,0.41714285714285715
BGL2,7,1058752,1058911,159,0.29559748427672955
YGR283C,7,1060084,1060473,389,0.3393316195372751
ERV29,7,1061632,1061780,148,0.35135135135135137
ZUO1,7,1063166,1063680,514,0.27626459143968873
BIO2,7,1065052,1065752,700,0.38857142857142857
IMA1,7,1069126,1069826,700,0.37857142857142856
MAL13,7,1069557,1070257,700,0.3871428571428571
MAL11,7,1076150,1076850,700,0.3757142857142857
RPL14B,8,104039,104255,216,0.3333333333333333
HSE1,8,102016,102578,562,0.3879003558718861
LAG1,8,102017,102579,562,0.3896797153024911
MRP4,8,98857,99134,277,0.36823104693140796
SHU1,8,98858,99135,277,0.37184115523465705
STE20,8,98072,98189,117,0.4188034188034188
YHL008C,8,94678,94977,299,0.34782608695652173
YAP3,8,85179,85879,700,0.3357142857142857
ETP1,8,83770,84470,700,0.37
PRS3,8,81716,81824,108,0.2962962962962963
YHL012W,8,78993,79693,700,0.3271428571428571
OTU2,8,78388,79088,700,0.31285714285714283
YLF2,8,77336,78036,700,0.3742857142857143
RPS20,8,74673,75373,700,0.3585714285714286
DUR3,8,74501,75201,700,0.38857142857142857
YHL017W,8,69693,70253,560,0.42142857142857143
YHL018W,8,69581,69693,112,0.375
APM2,8,69582,69694,112,0.375
OPI1,8,67540,67644,104,0.3942307692307692
AIM17,8,65919,66117,198,0.4898989898989899
NPR3,8,62595,63295,700,0.33285714285714285
RIM4,8,55951,56491,540,0.44074074074074077
SNF6,8,54240,54792,552,0.4076086956521739
YHL026C,8,54241,54793,552,0.4076086956521739
RIM101,8,50659,51012,353,0.38243626062322944
WSC4,8,47993,48693,700,0.4357142857142857
OCA5,8,47994,48694,700,0.4357142857142857
ECM29,8,39510,40066,556,0.35251798561151076
GOS1,8,39511,40067,556,0.35251798561151076
GUT1,8,38548,38755,207,0.357487922705314
RPL8A,8,36043,36318,275,0.28
SBP1,8,34188,34839,651,0.38863287250384027
VMR1,8,32791,33041,250,0.324
MUP3,8,25766,26210,444,0.39864864864864863
YHL037C,8,26506,27206,700,0.41285714285714287
CBP2,8,25544,25767,223,0.3721973094170404
EFM1,8,21310,21730,420,0.3880952380952381
ARN1,8,21311,21731,420,0.38571428571428573
YHL042W,8,15142,15842,700,0.3657142857142857
YHL044W,8,12831,13531,700,0.35285714285714287
ARN2,8,10289,10989,700,0.3942857142857143
COS8,8,5691,6391,700,0.4042857142857143
OSH7,8,105331,106031,700,0.3028571428571429
LEU5,8,108335,108663,328,0.3384146341463415
YHR003C,8,111328,111523,195,0.30256410256410254
NEM1,8,113283,113398,115,0.34782608695652173
GPA1,8,114992,115479,487,0.33059548254620125
STP2,8,117067,117767,700,0.36142857142857143
ERG11,8,121825,121897,72,0.2361111111111111
SOD2,8,123666,123675,9,0.4444444444444444
YHR009C,8,125913,126494,581,0.4165232358003442
RPL27A,8,125912,126493,581,0.41824440619621345
DIA4,8,127612,127758,146,0.3493150684931507
VPS29,8,129181,129459,278,0.35611510791366907
ARD1,8,131479,132179,700,0.3514285714285714
MIP6,8,134532,135232,700,0.33
YSC84,8,138516,138686,170,0.36470588235294116
YSC83,8,138515,138685,170,0.36470588235294116
ARG4,8,141457,141791,334,0.3652694610778443
DED81,8,143600,143911,311,0.4405144694533762
YHR020W,8,143599,143910,311,0.4405144694533762
RPS27B,8,148712,149168,456,0.40789473684210525
YHR022C,8,151003,151340,337,0.36795252225519287
MYO1,8,151339,151624,285,0.32280701754385965
MAS2,8,159221,159402,181,0.4088397790055249
THR1,8,159220,159401,181,0.4143646408839779
VMA16,8,160596,160728,132,0.3106060606060606
RPN1,8,164764,164874,110,0.37272727272727274
DAP2,8,167474,167595,121,0.39669421487603307
YHI9,8,168574,168749,175,0.3314285714285714
SLT2,8,170521,170687,166,0.3132530120481928
RRM3,8,173011,173225,214,0.2850467289719626
ERC1,8,173010,173224,214,0.2803738317757009
YHR033W,8,174391,175091,700,0.4785714285714286
PIH1,8,178033,178193,160,0.29375
YHR035W,8,178032,178192,160,0.2875
BRL1,8,179523,180223,700,0.38142857142857145
PUT2,8,181234,181934,700,0.3985714285714286
RRF1,8,183872,184039,167,0.38922155688622756
MSC7,8,186919,187060,141,0.24822695035460993
BCD1,8,187703,187907,204,0.3480392156862745
SRB2,8,189875,190503,628,0.4713375796178344
NCP1,8,189874,190502,628,0.4713375796178344
DOG2,8,193647,193943,296,0.35135135135135137
DOG1,8,194858,195421,563,0.3428063943161634
YHR045W,8,194857,195420,563,0.34458259325044405
INM1,8,198317,198592,275,0.33090909090909093
AAP1,8,201342,202042,700,0.3342857142857143
YHK8,8,203853,204553,700,0.38571428571428573
FSH1,8,205719,206419,700,0.41285714285714287
SMF2,8,207325,207473,148,0.4797297297297297
COX6,8,209365,209547,182,0.46153846153846156
CIC1,8,210425,210809,384,0.2864583333333333
RSC30,8,217883,218152,269,0.40892193308550184
CPR2,8,218859,219559,700,0.4357142857142857
MED6,8,219919,220056,137,0.32116788321167883
FYV4,8,219918,220055,137,0.3284671532846715
VMA22,8,220600,220710,110,0.3
GIC1,8,222615,222786,171,0.36257309941520466
RPP1,8,223785,223953,168,0.3333333333333333
PAN5,8,225202,225429,227,0.33480176211453744
SSZ1,8,227174,227422,248,0.34274193548387094
RRP3,8,229080,229303,223,0.273542600896861
SSF1,8,229079,229302,223,0.273542600896861
HTD2,8,230826,230936,110,0.4090909090909091
DYS1,8,231376,232076,700,0.38285714285714284
RRP4,8,234672,234863,191,0.29842931937172773
TRM5,8,234671,234862,191,0.29842931937172773
PCL5,8,236031,236622,591,0.4686971235194585
ERG7,8,238851,239034,183,0.2896174863387978
OSH3,8,241997,242503,506,0.3893280632411067
QNS1,8,245939,246126,187,0.3422459893048128
PPE1,8,249692,250392,700,0.3585714285714286
PTC7,8,250373,251073,700,0.36428571428571427
NMD2,8,255813,256332,519,0.35067437379576105
YHR078W,8,255812,256331,519,0.35067437379576105
IRE1,8,261847,262547,700,0.32142857142857145
YHR080C,8,267211,267518,307,0.38762214983713356
LRP1,8,267210,267517,307,0.39087947882736157
KSP1,8,272394,272611,217,0.4608294930875576
SAM35,8,272393,272610,217,0.45622119815668205
STE12,8,273694,273853,159,0.3018867924528302
IPI1,8,276543,276732,189,0.32275132275132273
NAM8,8,277873,277953,80,0.3625
RTC3,8,280044,280744,700,0.39285714285714285
RPF1,8,281338,281462,124,0.3387096774193548
GAR1,8,283330,283528,198,0.3434343434343434
YNG2,8,284661,284746,85,0.32941176470588235
MSR1,8,286807,287023,216,0.28703703703703703
HXT4,8,288886,289586,700,0.37714285714285717
HXT1,8,292660,293360,700,0.36142857142857143
HXT5,8,296778,297285,507,0.42011834319526625
YHR097C,8,298732,299003,271,0.43911439114391143
SFB3,8,302014,302670,656,0.37652439024390244
TRA1,8,302013,302669,656,0.375
GEP4,8,314725,315425,700,0.36
BIG1,8,316000,316398,398,0.4271356783919598
KIC1,8,315999,316397,398,0.42462311557788945
SBE22,8,319901,320222,321,0.3894080996884735
GRE3,8,323167,323309,142,0.36619718309859156
YPT35,8,324578,324653,75,0.4
TRR2,8,324880,325580,700,0.4328571428571429
CDC12,8,328094,328265,171,0.34502923976608185
GGA2,8,328093,328264,171,0.34502923976608185
CTM1,8,330196,330294,98,0.336734693877551
ERP5,8,332142,332252,110,0.38181818181818183
UBA4,8,333042,333064,22,0.3181818181818182
YHR112C,8,335697,336328,631,0.375594294770206
YHR113W,8,335696,336327,631,0.375594294770206
BZZ1,8,337960,337965,5,0.4
DMA1,8,341522,342222,700,0.47714285714285715
TOM71,8,341622,342322,700,0.46
ORC6,8,345663,345808,145,0.3103448275862069
SET1,8,345662,345807,145,0.30344827586206896
MSH1,8,349425,349546,121,0.3305785123966942
LSM12,8,352534,352675,141,0.3617021276595745
YHR122W,8,353402,353608,206,0.32524271844660196
EPT1,8,354464,354799,335,0.3701492537313433
NDT80,8,356985,357685,700,0.38285714285714284
YHR127W,8,360185,360885,700,0.3342857142857143
FUR1,8,361847,362071,224,0.32142857142857145
ARP1,8,364244,364900,656,0.32621951219512196
YHR130C,8,366893,367593,700,0.39285714285714285
YHR131C,8,368060,368383,323,0.38080495356037153
ECM14,8,369836,370021,185,0.3567567567567568
NSG1,8,371615,371748,133,0.2857142857142857
WSS1,8,371614,371747,133,0.2857142857142857
YCK1,8,374430,374560,130,0.4230769230769231
SPL2,8,375293,375679,386,0.36787564766839376
ARO9,8,375292,375678,386,0.3704663212435233
YHR138C,8,377771,378123,352,0.3465909090909091
SPS100,8,379883,380561,678,0.35693215339233036
YHR140W,8,379882,380560,678,0.35693215339233036
RPL42B,8,382777,383408,631,0.38351822503961963
CHS7,8,382776,383407,631,0.38351822503961963
DSE2,8,384564,385241,677,0.34859675036927623
DCD1,8,388756,389456,700,0.35714285714285715
CRP1,8,389564,390264,700,0.32857142857142857
MRPL6,8,393318,393511,193,0.3626943005181347
IMP3,8,393317,393510,193,0.3626943005181347
SKG6,8,396805,397209,404,0.32425742574257427
PEX28,8,396804,397208,404,0.3217821782178218
MTC6,8,401016,401384,368,0.35054347826086957
SPO12,8,401015,401383,368,0.35054347826086957
SPO16,8,402703,402919,216,0.3333333333333333
RTT107,8,402702,402918,216,0.3333333333333333
YSP1,8,406314,407014,700,0.34285714285714286
LIN1,8,412446,413146,700,0.35
REC104,8,411626,412326,700,0.3342857142857143
KEL1,8,417307,417474,167,0.40119760479041916
YHR159W,8,417306,417473,167,0.40718562874251496
PEX18,8,420067,420118,51,0.2549019607843137
YAP1801,8,422424,422895,471,0.4437367303609342
YHR162W,8,422423,422894,471,0.445859872611465
SOL3,8,423576,423715,139,0.37410071942446044
DNA2,8,429268,429636,368,0.35054347826086957
PRP8,8,437052,437072,20,0.5
CDC23,8,439124,439290,166,0.35542168674698793
THP2,8,439123,439289,166,0.3614457831325301
MTG2,8,440248,440342,94,0.32978723404255317
DBP8,8,441432,442132,700,0.36428571428571427
NMD3,8,443561,443779,218,0.3256880733944954
ATG7,8,445496,445703,207,0.32367149758454106
SPC97,8,447720,448252,532,0.32706766917293234
ENO2,8,451236,451296,60,0.23333333333333334
CTR2,8,451236,451296,60,0.23333333333333334
FMO1,8,453894,454149,255,0.38823529411764707
YHR177W,8,455863,456563,700,0.34285714285714286
STB5,8,458543,459243,700,0.3757142857142857
OYE2,8,461760,462460,700,0.3985714285714286
SVP26,8,467070,467194,124,0.23387096774193547
YHR182W,8,468008,468183,175,0.29714285714285715
GND1,8,470851,470882,31,0.3548387096774194
SSP1,8,473223,473923,700,0.31
KOG1,8,480752,480955,203,0.2955665024630542
IKI1,8,480751,480954,203,0.2955665024630542
GPI16,8,483866,484011,145,0.4068965517241379
PTH1,8,483865,484010,145,0.4
ERG9,8,484095,484795,700,0.49857142857142855
CTF8,8,486661,486791,130,0.26153846153846155
YHR192W,8,486660,486790,130,0.26153846153846155
EGD2,8,488268,488392,124,0.31451612903225806
MDM31,8,488391,488614,223,0.336322869955157
NVJ1,8,490484,490572,88,0.3977272727272727
UTP9,8,491176,491876,700,0.38571428571428573
RIX1,8,493708,493878,170,0.2823529411764706
AIM18,8,497288,497399,111,0.38738738738738737
AIM46,8,498444,498890,446,0.4641255605381166
RPN10,8,498889,499054,165,0.38181818181818183
PPX1,8,501166,501866,700,0.31285714285714283
YHR202W,8,501655,502355,700,0.33285714285714285
RPS4B,8,505569,506269,700,0.4085714285714286
MNL1,8,505571,506271,700,0.41
SCH9,8,508789,508943,154,0.3051948051948052
SKN7,8,512047,512245,198,0.3333333333333333
SET5,8,516568,517268,700,0.3871428571428571
BAT1,8,516800,517500,700,0.4
CRG1,8,518864,519403,539,0.37291280148423006
YHR210C,8,521821,522521,700,0.38
FLO5,8,522359,523059,700,0.3514285714285714
IMD2,8,553623,554323,700,0.3442857142857143
YIL001W,9,353583,353874,291,0.3230240549828179
INP51,9,353584,353875,291,0.3230240549828179
CFD1,9,348524,349075,551,0.3684210526315789
BET1,9,348525,349076,551,0.3666061705989111
EPS1,9,345371,345558,187,0.3155080213903743
YIA6,9,343699,343787,88,0.3068181818181818
NAS2,9,343700,343788,88,0.3068181818181818
URM1,9,341786,342486,700,0.33714285714285713
FAA3,9,338635,339335,700,0.38857142857142857
DOT5,9,334660,334844,184,0.3695652173913043
TIR3,9,332994,333694,700,0.41285714285714287
PDR11,9,330399,331099,700,0.3657142857142857
MNT3,9,325604,325928,324,0.345679012345679
BAR1,9,322622,323322,700,0.4014285714285714
SNL1,9,321034,321428,394,0.37817258883248733
RPL2B,9,316305,316743,438,0.3972602739726027
FAF1,9,314840,315072,232,0.41379310344827586
HIS6,9,314841,315073,232,0.41379310344827586
RPB3,9,312689,312842,153,0.40522875816993464
TIM44,9,310440,311055,615,0.3333333333333333
YKE4,9,310441,311056,615,0.3333333333333333
YIL024C,9,310426,310441,15,0.4
IRR1,9,307984,308487,503,0.3976143141153082
KRE27,9,304147,304331,184,0.375
YIL028W,9,301361,301565,204,0.35784313725490197
YIL029C,9,301362,301566,204,0.35784313725490197
SSM4,9,300066,300452,386,0.34196891191709844
ULP2,9,291776,292462,686,0.3979591836734694
BCY1,9,291777,292463,686,0.3979591836734694
CAP2,9,290102,290241,139,0.30935251798561153
CKA1,9,289018,289157,139,0.3669064748201439
CST6,9,284815,285515,700,0.33285714285714285
PRM2,9,284574,285274,700,0.35285714285714287
NOT3,9,282890,283086,196,0.3520408163265306
TED1,9,278232,278399,167,0.33532934131736525
APQ12,9,277589,277713,124,0.3064516129032258
GVP36,9,276318,276502,184,0.4076086956521739
PKP1,9,276319,276503,184,0.40217391304347827
CBR1,9,274946,274998,52,0.36538461538461536
AGE2,9,273872,273967,95,0.37894736842105264
PIG2,9,270685,271057,372,0.3924731182795699
MET30,9,268540,268591,51,0.39215686274509803
SYG1,9,267841,268116,275,0.4254545454545455
NEO1,9,260987,261113,126,0.3968253968253968
DFG10,9,259894,260151,257,0.31906614785992216
PCL7,9,258321,258798,477,0.41509433962264153
MMF1,9,258322,258799,477,0.41509433962264153
RPL34B,9,257094,257727,633,0.40916271721958924
GPP1,9,254422,255086,664,0.35843373493975905
YIL055C,9,254423,255087,664,0.35843373493975905
VHR1,9,249176,249876,700,0.44142857142857145
RGI2,9,249080,249780,700,0.46285714285714286
YIL059C,9,247463,248163,700,0.37714285714285717
SNP1,9,245578,245984,406,0.3399014778325123
ARC15,9,244489,245189,700,0.44
YRB2,9,243786,243853,67,0.373134328358209
SEE1,9,241813,242003,190,0.4368421052631579
FIS1,9,241814,242004,190,0.4421052631578947
YIL067C,9,237819,238519,700,0.37857142857142856
SEC6,9,235533,235641,108,0.42592592592592593
RPS24B,9,232414,232957,543,0.427255985267035
MAM33,9,231127,231368,241,0.3236514522821577
PCI8,9,230043,230163,120,0.3
SPO22,9,224576,225276,700,0.31142857142857144
SER33,9,222577,222816,239,0.3807531380753138
RPN2,9,220762,221028,266,0.3684210526315789
SEC28,9,216437,216645,208,0.3317307692307692
YIL077C,9,216438,216646,208,0.3317307692307692
THS1,9,212035,212455,420,0.3238095238095238
AIR1,9,212036,212456,420,0.32142857142857145
CAB2,9,204742,205442,700,0.3585714285714286
SDS3,9,203301,203460,159,0.2893081761006289
KTR7,9,202094,202794,700,0.3871428571428571
AIM19,9,200193,200429,236,0.3644067796610169
AVT7,9,199443,199554,111,0.4144144144144144
YIL089W,9,195396,195512,116,0.3103448275862069
ICE2,9,193225,193456,231,0.41125541125541126
UTP25,9,193226,193457,231,0.41125541125541126
YIL092W,9,188858,188998,140,0.3
RSM25,9,188859,188999,140,0.30714285714285716
LYS12,9,187659,187866,207,0.27053140096618356
PRK1,9,183143,183767,624,0.3301282051282051
YIL096C,9,183144,183768,624,0.3301282051282051
FYV10,9,180258,180417,159,0.3270440251572327
FMC1,9,180259,180418,159,0.3270440251572327
DPH1,9,171538,171700,162,0.2716049382716049
SHQ1,9,171539,171701,162,0.2777777777777778
SLM1,9,169782,169884,102,0.5392156862745098
MOB1,9,165931,166379,448,0.3080357142857143
PFK26,9,165932,166380,448,0.3080357142857143
YIL108W,9,160251,160862,611,0.35842880523731585
SEC24,9,160252,160863,611,0.35842880523731585
HPM1,9,155798,156013,215,0.31627906976744186
COX5B,9,154975,155190,215,0.3023255813953488
HOS4,9,151293,151553,260,0.3576923076923077
SDP1,9,150018,150521,503,0.38767395626242546
POR2,9,150019,150522,503,0.38767395626242546
NUP159,9,148820,149073,253,0.3675889328063241
HIS5,9,142193,142893,700,0.3357142857142857
PRM5,9,141656,142356,700,0.36142857142857143
RHO3,9,138937,139637,700,0.39571428571428574
RPI1,9,138068,138768,700,0.4057142857142857
QDR1,9,134551,135251,700,0.4085714285714286
QDR2,9,131820,132239,419,0.40572792362768495
POG1,9,129911,130322,411,0.4282238442822384
SIM1,9,127394,128094,700,0.37142857142857144
AYR1,9,125995,126172,177,0.3954802259887006
KGD1,9,122204,122407,203,0.45320197044334976
STH1,9,117667,117909,242,0.35537190082644626
RRT14,9,117668,117910,242,0.35537190082644626
MET18,9,113340,113729,389,0.37017994858611825
TAO3,9,113341,113730,389,0.37275064267352187
ASG1,9,102291,102656,365,0.3232876712328767
FKH1,9,102292,102657,365,0.32054794520547947
CSM2,9,100517,100631,114,0.34210526315789475
RPL16A,9,99437,99453,16,0.375
FLX1,9,96973,97370,397,0.3249370277078086
VHS2,9,96433,96974,541,0.3807763401109057
OM45,9,92892,93592,700,0.4114285714285714
TMA108,9,92828,93528,700,0.4157142857142857
TPM2,9,89726,89866,140,0.2714285714285714
REV7,9,88737,88879,142,0.34507042253521125
AXL2,9,84934,85262,328,0.38414634146341464
CCT2,9,83076,83274,198,0.3383838383838384
SSL2,9,83077,83275,198,0.3333333333333333
TID3,9,77318,77971,653,0.3614088820826952
PAN6,9,77319,77972,653,0.36294027565084225
ATG32,9,76129,76829,700,0.41
SLN1,9,73669,73969,300,0.33666666666666667
RPL40A,9,68204,68692,488,0.4077868852459016
MLP2,9,68205,68693,488,0.4098360655737705
MCM10,9,62759,62909,150,0.36666666666666664
YIL152W,9,56433,56527,94,0.2872340425531915
RRD1,9,55045,55166,121,0.371900826446281
IMP2',9,55046,55167,121,0.371900826446281
GUT2,9,53752,53907,155,0.4258064516129032
UBP7,9,48070,48104,34,0.35294117647058826
COA1,9,47551,47677,126,0.36507936507936506
AIM20,9,46024,46189,165,0.3333333333333333
BNR1,9,41092,41792,700,0.4085714285714286
POT1,9,41981,42681,700,0.37714285714285717
YIL161W,9,39202,39422,220,0.31363636363636366
SUC2,9,36649,37349,700,0.37714285714285717
NIT1,9,34716,35416,700,0.39
YIL165C,9,34716,35416,700,0.39
YIL166C,9,32965,33577,612,0.3611111111111111
SDL1,9,28266,28966,700,0.35428571428571426
YIL168W,9,28266,28966,700,0.35428571428571426
YIL169C,9,26146,26846,700,0.4257142857142857
SGN1,9,356947,357320,373,0.3324396782841823
MPH1,9,360704,360867,163,0.3128834355828221
AIM21,9,360703,360866,163,0.31901840490797545
DJP1,9,362993,363180,187,0.28342245989304815
IST3,9,364634,364843,209,0.3157894736842105
PAN1,9,370080,370697,617,0.31118314424635335
YIR007W,9,370079,370696,617,0.31280388978930307
PRI1,9,374365,374463,98,0.2857142857142857
MSL1,9,374364,374462,98,0.29591836734693877
DSN1,9,375309,375359,50,0.3
STS1,9,378262,378461,199,0.3969849246231156
SQT1,9,378261,378460,199,0.3969849246231156
YIR014W,9,380359,381059,700,0.3914285714285714
RPR2,9,381223,381923,700,0.4057142857142857
YIR016W,9,381223,381923,700,0.4057142857142857
MET28,9,384134,384588,454,0.40969162995594716
YAP5,9,384133,384587,454,0.4118942731277533
MUC1,9,392928,393628,700,0.42142857142857143
YIR020C,9,395627,396327,700,0.37857142857142856
MRS1,9,396551,397251,700,0.36857142857142855
SEC11,9,398444,398701,257,0.3968871595330739
DAL81,9,399340,399731,391,0.340153452685422
YIR024C,9,403532,403632,100,0.37
MND2,9,403531,403631,100,0.37
YVH1,9,406007,406184,177,0.3163841807909605
DAL1,9,406840,407540,700,0.46714285714285714
DAL4,9,409311,410011,700,0.41714285714285715
DAL2,9,410499,410696,197,0.3756345177664975
DCG1,9,412810,412950,140,0.3357142857142857
DAL7,9,414803,414959,156,0.358974358974359
DAL3,9,415679,416087,408,0.39215686274509803
MGA2,9,415678,416086,408,0.39215686274509803
LYS1,9,420771,420956,185,0.3945945945945946
YIR035C,9,421810,422006,196,0.3826530612244898
IRC24,9,422891,423059,168,0.3630952380952381
HYR1,9,422890,423058,168,0.3630952380952381
GTT1,9,424537,425237,700,0.4342857142857143
YPS6,9,432114,432511,397,0.3904282115869018
PAU15,9,432113,432510,397,0.3904282115869018
YIR042C,9,436073,436686,613,0.33931484502446985
YIR043C,9,438157,438184,27,0.3333333333333333
YIR044C,9,438184,438884,700,0.38142857142857145
PRE3,10,434702,435125,423,0.3664302600472813
OST1,10,434703,435126,423,0.3640661938534279
COX16,10,432212,432596,384,0.3463541666666667
SYS1,10,432213,432597,384,0.34375
CYR1,10,424297,424997,700,0.3757142857142857
CTK2,10,424165,424865,700,0.3871428571428571
CCT8,10,421706,422406,700,0.33285714285714285
NOP9,10,419596,419802,206,0.33495145631067963
RPC17,10,414800,415500,700,0.3414285714285714
VTC4,10,413419,414119,700,0.3585714285714286
MAD3,10,411026,411163,137,0.36496350364963503
CCT3,10,407388,407529,141,0.3404255319148936
YJL016W,10,404640,405340,700,0.4142857142857143
MPS3,10,402504,402793,289,0.314878892733564
BBC1,10,402505,402794,289,0.314878892733564
PET130,10,398415,398793,378,0.373015873015873
APS3,10,396623,397198,575,0.33043478260869563
RRN7,10,393743,393890,147,0.21768707482993196
RNR2,10,392316,392355,39,0.28205128205128205
YJL027C,10,392317,392356,39,0.3076923076923077
VPS53,10,390914,391614,700,0.4185714285714286
MAD2,10,387470,387612,142,0.2887323943661972
BET4,10,387471,387613,142,0.2887323943661972
HCA4,10,383581,383810,229,0.3406113537117904
KAR2,10,381053,381288,235,0.37446808510638296
TAD2,10,381054,381289,235,0.37446808510638296
SNX4,10,378005,378705,700,0.37285714285714283
IRC18,10,376968,377116,148,0.3581081081081081
LOH1,10,376969,377117,148,0.3581081081081081
NUP192,10,373977,374677,700,0.39571428571428574
NSP1,10,365532,365725,193,0.3160621761658031
MHP1,10,361012,361140,128,0.390625
YJL043W,10,359724,360228,504,0.38492063492063494
GYP6,10,359725,360229,504,0.38492063492063494
YJL045W,10,355048,355748,700,0.3757142857142857
AIM22,10,352227,352358,131,0.3511450381679389
RTT101,10,352228,352359,131,0.3511450381679389
UBX6,10,348711,349232,521,0.3896353166986564
YJL049W,10,345801,345949,148,0.35135135135135137
MTR4,10,342344,342473,129,0.26356589147286824
IRC8,10,339397,339711,314,0.3662420382165605
TDH1,10,337496,338196,700,0.44857142857142857
PEP8,10,335779,335854,75,0.18666666666666668
TIM54,10,334154,334256,102,0.38235294117647056
YJL055W,10,333152,333334,182,0.4065934065934066
ZAP1,10,333153,333335,182,0.4065934065934066
IKS1,10,330179,330313,134,0.3358208955223881
BIT61,10,327927,328036,109,0.3669724770642202
YHC3,10,324816,324936,120,0.275
BNA3,10,322668,323368,700,0.35285714285714287
NUP82,10,319868,319975,107,0.2803738317757009
LAS21,10,317156,317258,102,0.28431372549019607
MRPL8,10,316505,316695,190,0.43157894736842106
DLS1,10,315591,315680,89,0.25842696629213485
MPM1,10,314910,314931,21,0.42857142857142855
YJL068C,10,313940,314640,700,0.43714285714285717
UTP18,10,312722,312913,191,0.33507853403141363
YJL070C,10,310665,310840,175,0.2857142857142857
ARG2,10,305898,306080,182,0.32967032967032966
PSF2,10,305899,306081,182,0.32967032967032966
JEM1,10,302888,303070,182,0.3516483516483517
SMC3,10,302889,303071,182,0.3516483516483517
NET1,10,295046,295179,133,0.37593984962406013
PRY3,10,294057,294645,588,0.44047619047619047
PRY1,10,290938,291025,87,0.2988505747126437
SCP160,10,289427,289691,264,0.3371212121212121
ARP4,10,285303,285437,134,0.3283582089552239
IML2,10,281031,281130,99,0.31313131313131315
TAX4,10,278114,278785,671,0.38152011922503726
ALY2,10,278115,278786,671,0.38152011922503726
EXO70,10,272609,272746,137,0.3722627737226277
TRL1,10,272610,272747,137,0.3795620437956204
ARG3,10,268764,268776,12,0.5833333333333334
SIP4,10,265112,265812,700,0.38142857142857145
DPB11,10,265095,265795,700,0.3742857142857143
GWT1,10,262563,262674,111,0.36036036036036034
SRS2,10,256792,257208,416,0.3605769230769231
TOK1,10,256793,257209,416,0.3605769230769231
KHA1,10,254487,254601,114,0.39473684210526316
BCK1,10,247045,247148,103,0.34951456310679613
MRPL49,10,246297,246452,155,0.44516129032258067
PHS1,10,245259,245546,287,0.27526132404181186
SAP185,10,241199,241899,700,0.39285714285714285
CHS6,10,239166,239283,117,0.36752136752136755
LSB6,10,236498,237191,693,0.4314574314574315
GSH1,10,236499,237192,693,0.4314574314574315
MEF2,10,231075,231258,183,0.45901639344262296
GSM1,10,231076,231259,183,0.45901639344262296
PAM16,10,226707,227298,591,0.2859560067681895
SET4,10,223465,223611,146,0.3082191780821918
IME2,10,220144,220844,700,0.4157142857142857
YJL107C,10,220111,220811,700,0.40714285714285714
PRM10,10,219984,220111,127,0.33858267716535434
UTP10,10,217336,217533,197,0.26903553299492383
GZF3,10,211666,211912,246,0.34146341463414637
CCT7,10,207599,207825,226,0.33185840707964603
MDV1,10,204579,205279,700,0.3985714285714286
ASF1,10,195510,196210,700,0.40714285714285714
NCA3,10,195069,195769,700,0.42142857142857143
PHO86,10,192471,192480,9,0.5555555555555556
YJL118W,10,191147,191634,487,0.3757700205338809
YJL119C,10,192236,192466,230,0.4
YJL120W,10,190382,190535,153,0.5098039215686274
RPE1,10,191111,191148,37,0.40540540540540543
ALB1,10,189447,189698,251,0.38645418326693226
MTC1,10,189448,189699,251,0.38645418326693226
LSM1,10,187810,187900,90,0.37777777777777777
GCD14,10,186721,187016,295,0.26101694915254237
NIT2,10,184287,184493,206,0.32524271844660196
SPT10,10,184288,184494,206,0.32524271844660196
PBS2,10,180324,181024,700,0.38
TRK1,10,177583,178052,469,0.3582089552238806
URA2,10,172959,173511,552,0.33695652173913043
AIM23,10,165377,165599,222,0.3333333333333333
YJL132W,10,161702,161891,189,0.3386243386243386
MRS3,10,159871,160533,662,0.3957703927492447
LCB3,10,157442,158142,700,0.3871428571428571
RPS21B,10,157303,158003,700,0.37714285714285717
GLG2,10,156206,156414,208,0.3942307692307692
TIF2,10,154742,154846,104,0.28846153846153844
YUR1,10,153082,153314,232,0.2974137931034483
RPB4,10,150475,150866,391,0.37084398976982097
YAK1,10,150476,150867,391,0.3734015345268542
IRC9,10,150372,150476,104,0.33653846153846156
TIM17,10,146904,147054,150,0.4066666666666667
YJL144W,10,146126,146325,199,0.4020100502512563
SFH5,10,144930,145124,194,0.36082474226804123
IDS2,10,142645,143192,547,0.38939670932358317
YJL147C,10,142646,143193,547,0.3875685557586837
RPA34,10,139679,140379,700,0.3414285714285714
DAS1,10,136805,137351,546,0.36813186813186816
SNA3,10,136806,137352,546,0.36996336996337
INO1,10,136319,136806,487,0.459958932238193
VPS35,10,134020,134720,700,0.36142857142857143
FBP26,10,130786,131039,253,0.30039525691699603
SSY5,10,128977,129127,150,0.29333333333333333
CIS3,10,122985,123685,700,0.42714285714285716
HSP150,10,119694,120394,700,0.3742857142857143
YJL160C,10,119114,119814,700,0.3442857142857143
FMP33,10,116520,117220,700,0.35428571428571426
JJJ2,10,115689,116389,700,0.37142857142857144
YJL163C,10,113405,113765,360,0.30833333333333335
TPK1,10,111378,111605,227,0.3832599118942731
HAL5,10,109628,109869,241,0.3983402489626556
QCR8,10,106186,106367,181,0.39779005524861877
ERG20,10,104520,104957,437,0.3340961098398169
SET2,10,104521,104958,437,0.3340961098398169
YJL171C,10,100926,101626,700,0.4114285714285714
CPS1,10,97003,97703,700,0.38857142857142857
RFA3,10,96539,97239,700,0.3942857142857143
KRE9,10,94975,94976,1,0.0
YJL175W,10,91817,91837,20,0.2
SWI3,10,94593,94976,383,0.3733681462140992
RPL17B,10,90125,90764,639,0.405320813771518
ATG27,10,90126,90765,639,0.40375586854460094
PFD1,10,88576,88723,147,0.29931972789115646
ATP12,10,88577,88724,147,0.30612244897959184
YJL181W,10,85424,85637,213,0.3474178403755869
MNN11,10,83894,84002,108,0.3425925925925926
GON7,10,83018,83406,388,0.3634020618556701
YJL185C,10,83019,83407,388,0.3634020618556701
MNN5,10,79425,80125,700,0.3871428571428571
SWE1,10,79355,80055,700,0.39714285714285713
RPL39,10,75317,75897,580,0.38620689655172413
RPS22A,10,75318,75898,580,0.3879310344827586
RPS14B,10,73437,73762,325,0.3261538461538461
SOP4,10,73438,73763,325,0.3261538461538461
YJL193W,10,71011,71359,348,0.3505747126436782
CDC6,10,68804,69299,495,0.37575757575757573
ELO1,10,68805,69300,495,0.37575757575757573
UBP12,10,63578,63763,185,0.31351351351351353
PHO90,10,60199,60793,594,0.42592592592592593
MBB1,10,60200,60794,594,0.42424242424242425
ACO2,10,58836,59536,700,0.3271428571428571
ECM25,10,54329,54359,30,0.4
PRP21,10,53186,53306,120,0.31666666666666665
RCY1,10,53187,53307,120,0.31666666666666665
YJL206C,10,50094,50460,366,0.39617486338797814
LAA1,10,47453,47572,119,0.2773109243697479
NUC1,10,41241,41941,700,0.35
CBP1,10,37796,37928,132,0.3939393939393939
PEX2,10,36280,36866,586,0.4522184300341297
OPT1,10,36281,36867,586,0.4539249146757679
YJL213W,10,31114,31814,700,0.36142857142857143
HXT8,10,28337,28368,31,0.3225806451612903
YJL215C,10,28338,28369,31,0.2903225806451613
IMA5,10,26930,27630,700,0.4157142857142857
REE1,10,22708,23081,373,0.3753351206434316
YJL218W,10,21219,21919,700,0.3557142857142857
AVT1,10,436045,436745,700,0.28
MPP10,10,438720,438834,114,0.39473684210526316
YJR003C,10,442564,442679,115,0.3652173913043478
SAG1,10,444896,445596,700,0.3442857142857143
APL1,10,445180,445880,700,0.35714285714285715
POL31,10,448730,449193,463,0.3563714902807775
SUI2,10,450737,450923,186,0.34408602150537637
YJR008W,10,452060,452318,258,0.36046511627906974
TDH2,10,454729,455429,700,0.37714285714285717
MET3,10,455454,456154,700,0.3514285714285714
YJR011C,10,459471,459683,212,0.3490566037735849
YJR012C,10,460211,460342,131,0.2900763358778626
GPI14,10,460210,460341,131,0.29770992366412213
TMA22,10,461686,461781,95,0.29473684210526313
YJR015W,10,462536,462704,168,0.44642857142857145
ILV3,10,466223,466279,56,0.35714285714285715
ESS1,10,467055,467157,102,0.43137254901960786
YJR018W,10,466278,466575,297,0.3939393939393939
TES1,10,468295,468457,162,0.4506172839506173
YJR020W,10,467273,467469,196,0.5102040816326531
REC107,10,469614,469663,49,0.32653061224489793
LSM8,10,469613,469662,49,0.32653061224489793
MDE1,10,470979,470986,7,0.7142857142857143
BNA1,10,471701,472401,700,0.3657142857142857
YJR030C,10,486251,486469,218,0.3348623853211009
GEA1,10,490911,491058,147,0.30612244897959184
CPR7,10,490910,491057,147,0.30612244897959184
RAV1,10,496499,496608,109,0.3486238532110092
PET191,10,496498,496607,109,0.3577981651376147
RAD26,10,497082,497332,250,0.264
HUL4,10,503749,504449,700,0.42142857142857143
YJR039W,10,503002,503702,700,0.4042857142857143
GEF1,10,507310,507706,396,0.3333333333333333
URB2,10,513851,514032,181,0.39779005524861877
NUP85,10,513850,514031,181,0.39226519337016574
POL32,10,517581,518281,700,0.3628571428571429
VPS55,10,519269,519419,150,0.35333333333333333
SSC1,10,521741,522031,290,0.4896551724137931
TAH11,10,521740,522030,290,0.4896551724137931
ANB1,10,525431,526131,700,0.37142857142857144
CYC1,10,525588,526288,700,0.37857142857142856
UTR1,10,528494,528674,180,0.3888888888888889
ISY1,10,528493,528673,180,0.3888888888888889
OSM1,10,529678,529839,161,0.3105590062111801
RAD7,10,531436,532056,620,0.36129032258064514
BFA1,10,533823,533974,151,0.2913907284768212
YJR054W,10,535262,535962,700,0.37285714285714283
HIT1,10,538061,538761,700,0.33
YJR056C,10,542668,543368,700,0.35428571428571426
CDC8,10,543354,544054,700,0.3414285714285714
APS2,10,545206,545717,511,0.4461839530332681
PTK2,10,545205,545716,511,0.4481409001956947
CBF1,10,548436,548709,273,0.3443223443223443
YJR061W,10,550399,550414,15,0.4
NTA1,10,554863,555159,296,0.3141891891891892
RPA12,10,554862,555158,296,0.31756756756756754
CCT5,10,555715,555869,154,0.35714285714285715
ARP3,10,559184,559383,199,0.4271356783919598
TOR1,10,559183,559382,199,0.4221105527638191
YAE1,10,567450,567590,140,0.32857142857142857
RFC2,10,567449,567589,140,0.32857142857142857
HAM1,10,569432,569491,59,0.4576271186440678
LIA1,10,570630,570897,267,0.3408239700374532
NPA3,10,572159,572226,67,0.3283582089552239
OPI3,10,572959,573659,700,0.4757142857142857
MOG1,10,572225,572344,119,0.33613445378151263
HOC1,10,573851,573920,69,0.34782608695652173
CDC11,10,576649,577104,455,0.34065934065934067
MIR1,10,578217,578917,700,0.4514285714285714
AIM24,10,581645,581717,72,0.4027777777777778
EAF6,10,582362,582522,160,0.3125
ACF4,10,583556,583710,154,0.33116883116883117
CSN12,10,583555,583709,154,0.33116883116883117
YJR085C,10,585481,586181,700,0.35714285714285715
EMC2,10,587419,587535,116,0.3275862068965517
BIR1,10,587418,587534,116,0.33620689655172414
GRR1,10,594627,594778,151,0.3443708609271523
JSN1,10,598406,598631,225,0.38666666666666666
BUD4,10,598405,598630,225,0.38222222222222224
FIP1,10,604261,604406,145,0.3931034482758621
IME1,10,605813,606513,700,0.36142857142857143
SFC1,10,608987,609603,616,0.4155844155844156
YJR096W,10,611027,611104,77,0.45454545454545453
JJJ3,10,612130,612343,213,0.36619718309859156
YJR098C,10,615187,615468,281,0.3914590747330961
YUH1,10,615186,615467,281,0.3914590747330961
AIM25,10,617364,618064,700,0.36428571428571427
RSM26,10,617437,618137,700,0.37857142857142856
VPS25,10,619833,620533,700,0.31
URA8,10,620024,620724,700,0.32
SOD1,10,623057,623549,492,0.4817073170731707
ADO1,10,623056,623548,492,0.4817073170731707
ECM27,10,624648,624791,143,0.3986013986013986
YJR107W,10,625228,625928,700,0.42428571428571427
ABM1,10,628453,628845,392,0.3903061224489796
CPA2,10,633004,633489,485,0.3154639175257732
YMR1,10,633003,633488,485,0.3154639175257732
YJR111C,10,636890,637011,121,0.2727272727272727
NNF1,10,636889,637010,121,0.2809917355371901
RSM7,10,639030,639730,700,0.4757142857142857
YJR115W,10,639184,639884,700,0.4742857142857143
YJR116W,10,640683,640716,33,0.45454545454545453
STE24,10,641827,641977,150,0.32666666666666666
ILM1,10,644147,644223,76,0.2631578947368421
JHD2,10,646499,647199,700,0.3985714285714286
ATP2,10,646713,647413,700,0.42714285714285716
IBA57,10,649396,649708,312,0.34615384615384615
RPS5,10,651330,651864,534,0.3801498127340824
YJR124C,10,654277,654649,372,0.3118279569892473
ENT3,10,656023,656186,163,0.34355828220858897
VPS70,10,658674,658834,160,0.38125
RSF2,10,663730,663960,230,0.3521739130434783
YJR129C,10,665065,665083,18,0.3333333333333333
STR2,10,667165,667608,443,0.3295711060948081
MNS1,10,667164,667607,443,0.3295711060948081
NMD5,10,669357,669460,103,0.23300970873786409
XPT1,10,672831,672900,69,0.2898550724637681
SGM1,10,675893,676593,700,0.36142857142857143
MCM22,10,676830,676951,121,0.3140495867768595
TTI2,10,678726,678826,100,0.33
MET5,10,683482,684182,700,0.34
IML1,10,683841,684541,700,0.32
HOM6,10,690588,690626,38,0.3684210526315789
HIR3,10,695778,695873,95,0.3368421052631579
YJR141W,10,695777,695872,95,0.3368421052631579
YJR142W,10,697064,697124,60,0.35
PMT4,10,700664,700861,197,0.28426395939086296
MGM101,10,700663,700860,197,0.2893401015228426
RPS4A,10,703090,703576,486,0.39300411522633744
YJR146W,10,703089,703575,486,0.39300411522633744
HMS2,10,703575,704105,530,0.4528301886792453
BAT2,10,705643,705686,43,0.2558139534883721
YJR149W,10,705643,705686,43,0.2558139534883721
DAN1,10,709744,710444,700,0.36428571428571427
DAN4,10,717586,718286,700,0.3657142857142857
DAL5,10,718728,719428,700,0.3985714285714286
PGU1,10,722046,722746,700,0.3342857142857143
YJR154W,10,724850,725550,700,0.35714285714285715
AAD10,10,725550,726039,489,0.36400817995910023
MET14,11,439429,440129,700,0.3628571428571429
DID4,11,437532,437706,174,0.3563218390804598
MRP17,11,437533,437707,174,0.3563218390804598
AUR1,11,435003,435223,220,0.36818181818181817
BYE1,11,435004,435224,220,0.36818181818181817
RPL14A,11,431186,431886,700,0.3585714285714286
CAP1,11,428674,429264,590,0.3644067796610169
LAC1,11,428675,429265,590,0.3644067796610169
MRT4,11,425984,426202,218,0.3853211009174312
UFD4,11,425985,426203,218,0.3853211009174312
CCE1,11,421221,421365,144,0.3263888888888889
PRP40,11,418056,418255,199,0.39195979899497485
ARC19,11,418057,418256,199,0.39195979899497485
URB1,11,416941,417336,395,0.2911392405063291
PUT3,11,408069,408445,376,0.3670212765957447
ATP7,11,408070,408446,376,0.36436170212765956
HCS1,11,407249,407370,121,0.3140495867768595
SWD2,11,403919,404061,142,0.3028169014084507
RAM2,11,402141,402538,397,0.4282115869017632
SPT23,11,402142,402539,397,0.4282115869017632
CDC16,11,397157,397857,700,0.35
YKL023W,11,393409,393693,284,0.3380281690140845
URA6,11,393365,393410,45,0.35555555555555557
PAN3,11,392313,392423,110,0.32727272727272727
GPX1,11,389994,390178,184,0.41304347826086957
YKL027W,11,386794,387494,700,0.3457142857142857
TFA1,11,385013,385713,700,0.3585714285714286
MAE1,11,384762,385462,700,0.36428571428571427
IXR1,11,382029,382602,573,0.40663176265270506
TTI1,11,375284,375426,142,0.28169014084507044
TUL1,11,371555,371729,174,0.3620689655172414
UGP1,11,369285,369819,534,0.49250936329588013
YKL036C,11,369991,370691,700,0.42857142857142855
RGT1,11,364669,365369,700,0.38571428571428573
PTM1,11,361862,362503,641,0.3541341653666147
NFU1,11,361863,362504,641,0.35257410296411856
VPS24,11,359772,360048,276,0.3079710144927536
SPC42,11,358021,358336,315,0.33650793650793653
PHD1,11,356212,356480,268,0.41044776119402987
YKL044W,11,355512,356212,700,0.4328571428571429
PRI2,11,352868,353419,551,0.39201451905626133
DCW1,11,352869,353420,551,0.39201451905626133
YKL047W,11,349223,349431,208,0.3173076923076923
ELM1,11,349224,349432,208,0.3125
CSE4,11,346808,347114,306,0.2777777777777778
YKL050C,11,345843,345963,120,0.425
SFK1,11,340568,341176,608,0.4161184210526316
ASK1,11,340569,341177,608,0.4161184210526316
DEF1,11,338857,339067,210,0.3761904761904762
OAR1,11,336193,336322,129,0.3798449612403101
TMA19,11,334958,335658,700,0.3585714285714286
NUP120,11,334020,334279,259,0.2972972972972973
TOA2,11,329512,330135,623,0.29213483146067415
MPE1,11,329513,330136,623,0.29213483146067415
FBA1,11,327511,328028,517,0.3655705996131528
BLI1,11,325540,325752,212,0.3632075471698113
MSN4,11,322499,323199,700,0.44142857142857145
YKL063C,11,321684,322384,700,0.4057142857142857
MNR2,11,317092,317510,418,0.41866028708133973
YET1,11,317093,317511,418,0.42105263157894735
YNK1,11,314057,314757,700,0.32
NUP100,11,309756,310110,354,0.3559322033898305
YKL069W,11,306576,307276,700,0.35
YKL071W,11,304205,304905,700,0.33
STB6,11,299167,299343,176,0.38636363636363635
LHS1,11,296216,296390,174,0.3448275862068966
MUD2,11,296217,296391,174,0.3390804597701149
YKL075C,11,294396,294536,140,0.3
PSY1,11,294393,294396,3,0.3333333333333333
YKL077W,11,291141,291388,247,0.29959514170040485
DHR2,11,288645,288811,166,0.3072289156626506
SMY1,11,286274,286525,251,0.27091633466135456
VMA5,11,284659,284942,283,0.36395759717314485
TEF4,11,282375,282865,490,0.36122448979591837
RRP14,11,282376,282866,490,0.36122448979591837
HOT13,11,280161,280463,302,0.31788079470198677
MDH1,11,278729,279028,299,0.451505016722408
SRX1,11,277961,278259,298,0.3691275167785235
CYT2,11,277962,278260,298,0.36577181208053694
CAB3,11,275139,275253,114,0.30701754385964913
MIF2,11,272668,273368,700,0.36714285714285716
CUE2,11,271172,271872,700,0.3485714285714286
YKL091C,11,270686,271386,700,0.36857142857142855
BUD2,11,269535,269623,88,0.3522727272727273
MBR1,11,264378,264678,300,0.39666666666666667
YJU3,11,262623,263323,700,0.42142857142857143
YJU2,11,261944,262097,153,0.4117647058823529
CWP1,11,260384,261084,700,0.3871428571428571
MTC2,11,256546,256743,197,0.3604060913705584
UTP11,11,256547,256744,197,0.3604060913705584
YKL100C,11,255483,255614,131,0.3816793893129771
HSL1,11,247833,248533,700,0.39714285714285713
LAP4,11,247739,248439,700,0.39
GFA1,11,245575,245961,386,0.37305699481865284
YKL105C,11,242782,242979,197,0.36548223350253806
AAT1,11,237268,237437,169,0.33136094674556216
YKL107W,11,235853,236106,253,0.31620553359683795
SLD2,11,234031,234231,200,0.205
HAP4,11,231255,231955,700,0.4514285714285714
KTI12,11,229904,230604,700,0.36142857142857143
ABF1,11,225913,226402,489,0.36809815950920244
RAD27,11,225914,226403,489,0.36809815950920244
APN1,11,224492,224619,127,0.3228346456692913
PRR1,11,223109,223267,158,0.34177215189873417
SBA1,11,219584,220284,700,0.36714285714285716
VPH2,11,219260,219960,700,0.36142857142857143
OAC1,11,216821,217258,437,0.39588100686498856
DGR2,11,213233,213933,700,0.35
SRP21,11,213032,213732,700,0.36
YKL123W,11,210468,210494,26,0.3076923076923077
SSH4,11,210288,210468,180,0.4111111111111111
RRN3,11,207821,208155,334,0.3712574850299401
YPK1,11,205396,205498,102,0.5
PGM1,11,202815,203515,700,0.3942857142857143
PMU1,11,201794,202494,700,0.35714285714285715
MYO3,11,200258,200723,465,0.3548387096774194
SHE2,11,196078,196175,97,0.32989690721649484
RMA1,11,195002,195171,169,0.4378698224852071
YKL133C,11,193083,193421,338,0.28994082840236685
1-Oct,11,191494,191567,73,0.2602739726027397
APL2,11,188756,188861,105,0.3333333333333333
CMC1,11,185779,185890,111,0.3333333333333333
MRPL31,11,185780,185891,111,0.3333333333333333
CTK1,11,182587,182780,193,0.2849740932642487
TGL1,11,180369,180517,148,0.30405405405405406
SDH3,11,179313,179630,317,0.4037854889589905
MRP8,11,178259,178456,197,0.43147208121827413
LTV1,11,176519,176726,207,0.3526570048309179
RPC25,11,176520,176727,207,0.357487922705314
RPT1,11,173946,174181,235,0.34893617021276596
AVT3,11,171280,171761,481,0.4656964656964657
SDH1,11,171281,171762,481,0.4656964656964657
DBR1,11,168853,168974,121,0.33884297520661155
MCR1,11,165934,166480,546,0.4194139194139194
YKL151C,11,165935,166481,546,0.42124542124542125
GPM1,11,164408,165108,700,0.39714285714285713
SRP102,11,161396,161520,124,0.27419354838709675
RSM22,11,161397,161521,124,0.2661290322580645
RPS27A,11,158375,158594,219,0.3424657534246575
APE2,11,154478,154966,488,0.3790983606557377
RCN1,11,154479,154967,488,0.3790983606557377
ELF1,11,152556,153256,700,0.3142857142857143
KDX1,11,150759,151459,700,0.35
YKL162C,11,148947,149062,115,0.43478260869565216
PIR3,11,142899,143599,700,0.3628571428571429
PIR1,11,142897,143597,700,0.3628571428571429
MCD4,11,140745,141445,700,0.3342857142857143
TPK3,11,135868,136568,700,0.36
MRP49,11,134154,134289,135,0.3851851851851852
KKQ8,11,133471,133569,98,0.3469387755102041
MRPL38,11,130408,130560,152,0.40131578947368424
NNK1,11,127140,127325,185,0.4702702702702703
EBP2,11,125645,125729,84,0.2857142857142857
SNU114,11,122321,122491,170,0.4117647058823529
TPO5,11,122322,122492,170,0.4117647058823529
ZRT3,11,118331,118746,415,0.38072289156626504
LST4,11,118332,118747,415,0.38072289156626504
STE3,11,114671,115371,700,0.3514285714285714
COY1,11,112520,112942,422,0.3459715639810427
RPL17A,11,108671,109247,576,0.3871527777777778
PRS1,11,106902,107139,237,0.3333333333333333
FAS1,11,99768,100118,350,0.49714285714285716
LOT5,11,98439,98577,138,0.3188405797101449
SPE1,11,96377,96596,219,0.3744292237442922
ASH1,11,93450,94150,700,0.39571428571428574
MTR2,11,93348,94048,700,0.4042857142857143
YKL187C,11,91571,92271,700,0.4157142857142857
PXA2,11,89011,89711,700,0.37
HYM1,11,83904,84604,700,0.36142857142857143
CNB1,11,82735,82905,170,0.43529411764705883
DPH2,11,80574,81007,433,0.3579676674364896
ACP1,11,80575,81008,433,0.36027713625866054
SDS22,11,79921,80020,99,0.29292929292929293
MST1,11,78685,78760,75,0.36
MIA40,11,75580,75786,206,0.39805825242718446
YKT6,11,75581,75787,206,0.39805825242718446
PEX1,11,73899,74599,700,0.37285714285714283
PTK1,11,70394,70397,3,0.3333333333333333
MNN4,11,67623,68094,471,0.42462845010615713
TOR2,11,63551,63703,152,0.3157894736842105
EAP1,11,53478,53669,191,0.31413612565445026
LOS1,11,49830,50019,189,0.30158730158730157
ADD66,11,49831,50020,189,0.30158730158730157
AIM27,11,48106,48159,53,0.33962264150943394
CBT1,11,46441,47141,700,0.3271428571428571
STE6,11,45284,45984,700,0.3742857142857143
UBA1,11,38419,39119,700,0.4014285714285714
TRP3,11,38236,38936,700,0.4042857142857143
SAC1,11,34144,34383,239,0.39330543933054396
DOA1,11,34145,34384,239,0.39748953974895396
YRA2,11,31757,31885,128,0.3125
OXP1,11,30756,31023,267,0.3445692883895131
URA1,11,24472,25172,700,0.3985714285714286
JEN1,11,21380,22080,700,0.43714285714285717
SRY1,11,18412,19112,700,0.3457142857142857
COS9,11,13836,14536,700,0.35428571428571426
FRE2,11,11381,12081,700,0.3457142857142857
MCH2,11,5737,6095,358,0.30726256983240224
YKL222C,11,5738,6096,358,0.30726256983240224
VPS1,11,442769,443027,258,0.4263565891472868
PAP1,11,442768,443026,258,0.4263565891472868
OSH6,11,444992,445291,299,0.38127090301003347
ECM9,11,448080,448292,212,0.2971698113207547
YKR005C,11,451257,451417,160,0.425
MRPL13,11,451228,451257,29,0.5172413793103449
MEH1,11,451256,451416,160,0.43125
RSC4,11,452071,452173,102,0.39215686274509803
FOX2,11,457269,457969,700,0.3414285714285714
TOF2,11,461330,461524,194,0.30412371134020616
YKR011C,11,462815,463515,700,0.4185714285714286
YKR012C,11,465013,465075,62,0.27419354838709675
PRY2,11,463661,463918,257,0.3968871595330739
YPT52,11,466214,466914,700,0.3485714285714286
YKR015C,11,469341,469671,330,0.3242424242424242
FCJ1,11,469340,469670,330,0.3242424242424242
YKR017C,11,473456,473570,114,0.4473684210526316
YKR018C,11,475922,476123,201,0.38308457711442784
IRS4,11,478159,478321,162,0.4444444444444444
VPS51,11,478158,478320,162,0.4444444444444444
ALY1,11,479068,479164,96,0.3541666666666667
NTR2,11,483191,483371,180,0.37222222222222223
YKR023W,11,483190,483370,180,0.37222222222222223
DBP7,11,487399,487739,340,0.29411764705882354
RPC37,11,487398,487738,340,0.29411764705882354
GCN3,11,489752,490452,700,0.3157142857142857
BCH2,11,490564,491264,700,0.32142857142857145
SAP190,11,493741,493896,155,0.34838709677419355
SET3,11,499838,500230,392,0.29336734693877553
GMH1,11,499837,500229,392,0.29591836734693877
SPO14,11,506510,506898,388,0.37628865979381443
DAL80,11,506509,506897,388,0.37628865979381443
CAF4,11,510663,510746,83,0.26506024096385544
SPC34,11,511836,511890,54,0.2222222222222222
KAE1,11,513170,513870,700,0.33
GAP1,11,514298,514998,700,0.4
YKR041W,11,517488,518188,700,0.3357142857142857
UTH1,11,518619,519319,700,0.4857142857142857
YKR043C,11,521736,521936,200,0.285
UIP5,11,521735,521935,200,0.28
YKR045C,11,523997,524059,62,0.20967741935483872
PET10,11,525083,525255,172,0.3488372093023256
NAP1,11,526659,526767,108,0.4166666666666667
FMP46,11,527249,527949,700,0.4642857142857143
TRK2,11,526766,526865,99,0.31313131313131315
YKR051W,11,530576,530828,252,0.2857142857142857
MRS4,11,533535,533976,441,0.40816326530612246
YSR3,11,536090,536790,700,0.3914285714285714
DYN1,11,548070,548174,104,0.3942307692307692
RHO4,11,548069,548173,104,0.40384615384615385
TRM2,11,549398,549545,147,0.2925170068027211
RPS21A,11,551481,551626,145,0.3103448275862069
GLG1,11,552419,552588,169,0.3905325443786982
TIF1,11,554743,554958,215,0.3395348837209302
UTP30,11,556284,556490,206,0.28640776699029125
KTR2,11,557447,557594,147,0.272108843537415
TFA2,11,559023,559604,581,0.36316695352839934
LAS1,11,562303,562503,200,0.32
OAF3,11,562302,562502,200,0.32
PAM17,11,565921,566021,100,0.32
CCP1,11,567218,567820,602,0.45348837209302323
GPT2,11,567217,567819,602,0.45348837209302323
BET3,11,570957,571452,495,0.3575757575757576
MET1,11,570956,571451,495,0.3595959595959596
YKR070W,11,573427,573566,139,0.4028776978417266
DRE2,11,576023,576335,312,0.2724358974358974
SIS2,11,578288,578988,700,0.4014285714285714
AIM29,11,578464,579164,700,0.3871428571428571
YKR075C,11,580785,580824,39,0.4358974358974359
ECM4,11,581505,582205,700,0.3628571428571429
MSA2,11,583470,583627,157,0.31210191082802546
YKR078W,11,584836,584934,98,0.37755102040816324
TRZ1,11,589527,590227,700,0.3871428571428571
MTD1,11,589631,590331,700,0.3842857142857143
RPF2,11,592565,592777,212,0.2971698113207547
NUP133,11,592564,592776,212,0.2971698113207547
DAD2,11,596882,596947,65,0.3230769230769231
HBS1,11,598942,599015,73,0.3424657534246575
MRPL20,11,599697,599833,136,0.3161764705882353
PRP16,11,599696,599832,136,0.3235294117647059
OMA1,11,604254,604332,78,0.34615384615384615
TVP38,11,605431,605551,120,0.30833333333333335
TGL4,11,608442,608792,350,0.31142857142857144
PXL1,11,608441,608791,350,0.30857142857142855
SRL3,11,611206,611490,284,0.33098591549295775
SRP40,11,613914,614614,700,0.38142857142857145
PTR2,11,614935,615635,700,0.4342857142857143
RPL40B,11,618777,619477,700,0.35714285714285715
MLP1,11,618935,619635,700,0.3457142857142857
YKR096W,11,626325,626632,307,0.39087947882736157
PCK1,11,630485,631004,519,0.43352601156069365
UBP11,11,635316,635591,275,0.33454545454545453
BAS1,11,635315,635590,275,0.33090909090909093
SKG1,11,640319,640530,211,0.33649289099526064
SIR1,11,640318,640529,211,0.33649289099526064
FLO10,11,642735,642959,224,0.3169642857142857
NFT1,11,650047,650479,432,0.3263888888888889
YKR104W,11,655292,655992,700,0.39
DNM1,12,147674,147826,152,0.4473684210526316
RTT109,12,146100,146266,166,0.3493975903614458
SFI1,12,142997,143187,190,0.33157894736842103
ORC3,12,140355,141055,700,0.30857142857142855
MMM1,12,136385,136547,162,0.3148148148148148
YLL007C,12,136386,136548,162,0.32098765432098764
DRS1,12,131462,131698,236,0.3305084745762712
COX17,12,131463,131699,236,0.3305084745762712
PSR1,12,130838,131088,250,0.396
SOF1,12,127341,127511,170,0.3235294117647059
YEH1,12,124959,125480,521,0.345489443378119
PUF3,12,124960,125481,521,0.3474088291746641
EMC6,12,121177,121303,126,0.3253968253968254
BPT1,12,115605,116305,700,0.3385714285714286
DPS1,12,111604,112304,700,0.36857142857142855
SPA2,12,100230,100809,579,0.3626943005181347
HIF1,12,100231,100810,579,0.3609671848013817
POM33,12,98889,98982,93,0.3655913978494624
SSA2,12,97515,97858,343,0.3673469387755102
PAU17,12,94018,94718,700,0.38142857142857145
HSP104,12,88271,88566,295,0.3593220338983051
ISA1,12,86954,87204,250,0.42
TPO1,12,83961,84661,700,0.43
FRA1,12,80651,81351,700,0.34285714285714286
GPI13,12,80259,80959,700,0.3385714285714286
YLL032C,12,76878,77059,181,0.24861878453038674
IRC19,12,73183,73402,219,0.3561643835616438
RIX7,12,73184,73403,219,0.3561643835616438
GRC3,12,68276,68477,201,0.3781094527363184
PRP19,12,68277,68478,201,0.3781094527363184
YLL037W,12,65312,65674,362,0.4171270718232044
ENT4,12,66552,66675,123,0.3089430894308943
UBI4,12,65313,65675,362,0.4198895027624309
VPS13,12,63766,63943,177,0.3389830508474576
SDH2,12,53997,54094,97,0.3917525773195876
ATG10,12,52662,52763,101,0.24752475247524752
FPS1,12,49199,49899,700,0.4142857142857143
RPL8B,12,48652,49352,700,0.37142857142857144
YBT1,12,46454,47154,700,0.3385714285714286
LDB18,12,40438,40657,219,0.3789954337899543
COF1,12,40439,40658,219,0.3835616438356164
FRE6,12,39485,39680,195,0.38974358974358975
AQY2,12,36393,37093,700,0.3742857142857143
YLL053C,12,36393,37093,700,0.3742857142857143
YLL054C,12,35232,35404,172,0.3313953488372093
YCT1,12,29515,29805,290,0.44482758620689655
YLL056C,12,29516,29806,290,0.4413793103448276
JLP1,12,26661,27288,627,0.3923444976076555
YLL058W,12,23175,23501,326,0.39570552147239263
YLL059C,12,23176,23502,326,0.39263803680981596
GTT2,12,22694,23176,482,0.3879668049792531
MMP1,12,17678,17939,261,0.37547892720306514
MHT1,12,17679,17940,261,0.37547892720306514
AYT1,12,16037,16506,469,0.3646055437100213
YLR001C,12,154008,154276,268,0.34328358208955223
NOC3,12,156372,156766,394,0.3401015228426396
CMS1,12,157748,157860,112,0.35714285714285715
THI73,12,159560,160012,452,0.39823008849557523
SSL1,12,159559,160011,452,0.39823008849557523
SSK1,12,164078,164380,302,0.32781456953642385
NSE1,12,164077,164379,302,0.33112582781456956
PAM18,12,166181,166393,212,0.4056603773584906
RLP24,12,166180,166392,212,0.41037735849056606
TEN1,12,167813,168513,700,0.34285714285714286
LOT6,12,168323,169023,700,0.33
PPR1,12,175022,175174,152,0.3157894736842105
BRE2,12,175021,175173,152,0.3223684210526316
PML1,12,177458,177600,142,0.31690140845070425
MEU1,12,177457,177599,142,0.30985915492957744
POM34,12,179659,179984,325,0.25846153846153846
PSR2,12,179658,179983,325,0.25846153846153846
YEH2,12,183444,183582,138,0.30434782608695654
IRC25,12,183443,183581,138,0.30434782608695654
SDO1,12,184931,185090,159,0.2830188679245283
IZH3,12,187256,187318,62,0.2903225806451613
UBR2,12,193492,194192,700,0.3942857142857143
SNF7,12,193679,194379,700,0.36857142857142855
SED5,12,196587,196766,179,0.2737430167597765
AAT2,12,198111,198811,700,0.36428571428571427
ADE16,12,201478,201841,363,0.3884297520661157
RPL15A,12,202613,203313,700,0.32571428571428573
RAD5,12,204219,204919,700,0.3442857142857143
RSC58,12,208567,208707,140,0.32857142857142857
SMF3,12,212098,212103,5,0.6
MLH2,12,214487,215187,700,0.36714285714285716
YLR036C,12,222177,222534,357,0.3389355742296919
PAU23,12,223263,223963,700,0.3942857142857143
COX12,12,225228,225356,128,0.3671875
RIC1,12,228564,228769,205,0.3463414634146341
YLR040C,12,229662,229860,198,0.30808080808080807
YLR041W,12,228768,229064,296,0.36824324324324326
YLR042C,12,230537,230645,108,0.2962962962962963
TRX1,12,232043,232313,270,0.3814814814814815
PDC1,12,234111,234811,700,0.3485714285714286
STU2,12,237722,237875,153,0.3202614379084967
YLR046C,12,240216,240916,700,0.36714285714285716
FRE8,12,241655,242200,545,0.3889908256880734
RPS0B,12,241654,242199,545,0.3889908256880734
YLR049C,12,245363,245495,132,0.3333333333333333
YLR050C,12,246096,246223,127,0.33858267716535434
FCF2,12,246998,247176,178,0.34831460674157305
IES3,12,246997,247175,178,0.3539325842696629
YLR053C,12,248380,248596,216,0.35185185185185186
OSW2,12,249756,250456,700,0.35285714285714287
SPT8,12,253164,253789,625,0.4544
ERG3,12,253163,253788,625,0.4528
YLR057W,12,255084,255251,167,0.3473053892215569
SHM2,12,259440,259554,114,0.3684210526315789
REX2,12,260583,260942,359,0.362116991643454
FRS1,12,260582,260941,359,0.362116991643454
RPL22A,12,262864,263172,308,0.30194805194805197
YLR063W,12,264038,264231,193,0.27979274611398963
PER33,12,265383,265409,26,0.4230769230769231
YLR065C,12,266951,267132,181,0.35911602209944754
SPC3,12,266950,267131,181,0.36464088397790057
PET309,12,270820,270980,160,0.31875
FYV7,12,270819,270979,160,0.31875
MEF1,12,273931,274052,121,0.34710743801652894
XYL2,12,275268,275968,700,0.37142857142857144
RGR1,12,278648,278842,194,0.36597938144329895
YLR072W,12,278647,278841,194,0.36597938144329895
RFU1,12,281733,281889,156,0.3076923076923077
BUD20,12,282488,282906,418,0.33253588516746413
RPL10,12,282487,282905,418,0.33253588516746413
FMP25,12,283732,283832,100,0.39
BOS1,12,286612,286780,168,0.39285714285714285
SIC1,12,286611,286779,168,0.39285714285714285
EMP46,12,287827,287897,70,0.3142857142857143
GAL2,12,289459,290159,700,0.41714285714285715
SRL2,12,293609,293930,321,0.3364485981308411
EMP70,12,296249,296476,227,0.3436123348017621
RAX2,12,300404,300570,166,0.3072289156626506
ARP6,12,302022,302187,165,0.3393939393939394
SMC4,12,302021,302186,165,0.3393939393939394
CSF1,12,315932,316075,143,0.40559440559440557
GAA1,12,315931,316074,143,0.3986013986013986
ALT1,12,320217,320656,439,0.4123006833712984
XDJ1,12,320216,320655,439,0.4123006833712984
GEP5,12,322206,322295,89,0.47191011235955055
SUL2,12,324395,325095,700,0.41285714285714287
NYV1,12,327482,327611,129,0.3798449612403101
GIS3,12,329272,329616,344,0.4418604651162791
IOC2,12,332144,332344,200,0.36
KIN2,12,332143,332343,200,0.36
HRT3,12,337328,337382,54,0.35185185185185186
CHA4,12,339485,339637,152,0.3881578947368421
ICT1,12,340979,341291,312,0.46474358974358976
ERG27,12,341648,341782,134,0.39552238805970147
APC9,12,343780,343911,131,0.32061068702290074
CDC45,12,346011,346545,534,0.352059925093633
LCL2,12,346010,346544,534,0.352059925093633
SEN2,12,348232,348828,596,0.33053691275167785
MDN1,12,363876,364100,224,0.29910714285714285
REX3,12,363875,364099,224,0.29910714285714285
YLR108C,12,368180,368744,564,0.3900709219858156
AHP1,12,368179,368743,564,0.3900709219858156
CCW12,12,370141,370748,607,0.44481054365733114
YLR112W,12,370140,370747,607,0.44481054365733114
HOG1,12,371364,371445,81,0.2716049382716049
AVL9,12,377303,377961,658,0.3662613981762918
CFT2,12,377302,377960,658,0.3662613981762918
MSL5,12,380711,380817,106,0.32075471698113206
CLF1,12,384546,384622,76,0.34210526315789475
YLR118C,12,385449,385568,119,0.3025210084033613
SRN2,12,385448,385567,119,0.31092436974789917
YPS1,12,388333,388551,218,0.39908256880733944
YPS3,12,390293,390315,22,0.18181818181818182
YLR122C,12,391633,391690,57,0.38596491228070173
YLR123C,12,391690,392390,700,0.38285714285714284
YLR125W,12,392096,392796,700,0.3742857142857143
YLR126C,12,395593,395644,51,0.2549019607843137
APC2,12,398396,398486,90,0.34444444444444444
DCN1,12,398395,398485,90,0.34444444444444444
DIP2,12,398904,399604,700,0.3914285714285714
ZRT2,12,404178,404878,700,0.39571428571428574
YLR132C,12,408182,408413,231,0.3722943722943723
CKI1,12,408181,408412,231,0.3722943722943723
PDC5,12,409979,410679,700,0.37285714285714283
SLX4,12,412536,413216,680,0.29558823529411765
TIS11,12,416666,416999,333,0.45345345345345345
YLR137W,12,416665,416998,333,0.45345345345345345
NHA1,12,418157,418337,180,0.4388888888888889
SLS1,12,423495,423650,155,0.3032258064516129
RRN5,12,423494,423649,155,0.3096774193548387
PUT1,12,424483,425183,700,0.42142857142857143
YLR143W,12,426735,427314,579,0.37305699481865284
ACF2,12,432035,432159,124,0.23387096774193547
RMP1,12,432034,432158,124,0.23387096774193547
SPE4,12,433767,433849,82,0.2682926829268293
SMD3,12,434494,434603,109,0.27522935779816515
PEP3,12,434493,434602,109,0.27522935779816515
YLR149C,12,439900,440436,536,0.35447761194029853
STM1,12,439899,440435,536,0.35634328358208955
PCD1,12,442738,442872,134,0.34328358208955223
YLR152C,12,444846,445263,417,0.42685851318944845
ACS2,12,447606,447909,303,0.3795379537953795
RNH203,12,448369,449069,700,0.37285714285714283
MAS1,12,493282,493535,253,0.3557312252964427
YLR164W,12,493281,493534,253,0.3557312252964427
PUS5,12,495266,495368,102,0.3333333333333333
SEC10,12,498080,498780,700,0.3457142857142857
RPS31,12,498189,498889,700,0.3414285714285714
UPS2,12,500370,501070,700,0.4
APS1,12,501086,501177,91,0.38461538461538464
DPH5,12,502190,502355,165,0.3575757575757576
YLR173W,12,502189,502354,165,0.3575757575757576
IDP2,12,503603,504303,700,0.44571428571428573
CBF5,12,505911,506104,193,0.2538860103626943
RFX1,12,510187,510887,700,0.45714285714285713
YLR177W,12,510304,511004,700,0.48714285714285716
TFS1,12,514362,514790,428,0.4672897196261682
YLR179C,12,514790,515206,416,0.37259615384615385
SAM1,12,514789,515205,416,0.37259615384615385
VTA1,12,517738,517907,169,0.26627218934911245
SWI6,12,517737,517906,169,0.27218934911242604
TOS4,12,522059,522642,583,0.3927958833619211
RPL37A,12,522058,522641,583,0.3927958833619211
EMG1,12,523384,523576,192,0.3385416666666667
SKG3,12,524454,524670,216,0.39814814814814814
MDL1,12,527998,528226,228,0.32894736842105265
ATG26,12,534453,534836,383,0.3472584856396867
MMR1,12,534452,534835,383,0.3472584856396867
PEX13,12,537076,537222,146,0.3561643835616438
HCR1,12,539638,539838,200,0.345
UPS1,12,540589,540742,153,0.3333333333333333
YLR194C,12,541588,541863,275,0.37454545454545457
NMT1,12,543327,543894,567,0.3333333333333333
PWP1,12,543326,543893,567,0.3315696649029982
NOP56,12,545827,546060,233,0.2918454935622318
PBA1,12,548816,548984,168,0.31547619047619047
YKE2,12,548815,548983,168,0.31547619047619047
COQ9,12,550320,550528,208,0.3557692307692308
YLR202C,12,552024,552240,216,0.4212962962962963
MSS51,12,552023,552024,1,0.0
QRI5,12,552023,552239,216,0.4166666666666667
HMX1,12,553717,554417,700,0.4585714285714286
ENT2,12,553730,554430,700,0.46
HRD3,12,556574,556776,202,0.400990099009901
SEC13,12,559346,559460,114,0.40350877192982454
PNP1,12,561739,561945,206,0.33980582524271846
CLB4,12,561738,561944,206,0.33980582524271846
YLR211C,12,564581,564713,132,0.3787878787878788
TUB4,12,566296,566518,222,0.3153153153153153
CRR1,12,567963,568484,521,0.362763915547025
FRE1,12,567962,568483,521,0.362763915547025
CDC123,12,571900,571984,84,0.39285714285714285
CPR6,12,573242,573339,97,0.3917525773195876
YLR217W,12,572136,572836,700,0.3842857142857143
COA4,12,573811,573956,145,0.4
MSC3,12,573810,573955,145,0.4
CCC1,12,576495,576676,181,0.3425414364640884
RSA3,12,579069,579220,151,0.31788079470198677
UTP13,12,581790,582490,700,0.35714285714285715
YLR224W,12,585607,586307,700,0.3514285714285714
YLR225C,12,588967,589305,338,0.28994082840236685
BUR2,12,588966,589304,338,0.28994082840236685
ADY4,12,592392,593092,700,0.32857142857142857
ECM22,12,602666,603366,700,0.38285714285714284
CDC42,12,604996,605650,654,0.3853211009174312
BNA5,12,607146,607846,700,0.39285714285714285
EST1,12,609557,609743,186,0.3817204301075269
TOP3,12,609556,609742,186,0.3763440860215054
THI7,12,612266,612299,33,0.3333333333333333
FAR10,12,614348,614676,328,0.3201219512195122
LIP2,12,617336,617485,149,0.30201342281879195
VPS34,12,617335,617484,149,0.3087248322147651
YLR241W,12,620303,620425,122,0.38524590163934425
ARV1,12,623984,624125,141,0.3191489361702128
YLR243W,12,623983,624124,141,0.3191489361702128
MAP1,12,626349,626948,599,0.39398998330550916
CDD1,12,626948,627117,169,0.35502958579881655
ERF2,12,626947,627116,169,0.35502958579881655
IRC20,12,633379,634079,700,0.3842857142857143
RCK2,12,633493,634193,700,0.36
YEF3,12,636220,636739,519,0.3333333333333333
SSP120,12,640042,640272,230,0.3217391304347826
SYM1,12,640272,640810,538,0.3903345724907063
YLR252W,12,641140,641348,208,0.33653846153846156
YLR253W,12,642392,642553,161,0.36024844720496896
NDL1,12,645062,645434,372,0.3333333333333333
YLR255C,12,645981,646681,700,0.4228571428571429
YLR257W,12,657921,658621,700,0.39714285714285713
GSY2,12,659948,660648,700,0.4357142857142857
HSP60,12,665036,665716,680,0.38088235294117645
LCB5,12,665035,665715,680,0.38088235294117645
VPS63,12,668931,669370,439,0.357630979498861
YPT6,12,668931,669370,439,0.357630979498861
RED1,12,669683,669841,158,0.33544303797468356
RPS28B,12,672891,673108,217,0.3317972350230415
NEJ1,12,675531,675586,55,0.41818181818181815
PDR8,12,677747,678142,395,0.42025316455696204
BOP2,12,677746,678141,395,0.42278481012658226
SEC22,12,680020,680148,128,0.2890625
DCS1,12,680960,681093,133,0.45112781954887216
YLR271W,12,682450,682604,154,0.37662337662337664
YCS4,12,687254,687954,700,0.31285714285714283
PIG1,12,691258,691535,277,0.36101083032490977
MCM5,12,691257,691534,277,0.36101083032490977
SMD2,12,694013,694322,309,0.3365695792880259
DBP9,12,696926,697093,167,0.2934131736526946
YSH1,12,699643,699811,168,0.3630952380952381
YLR278C,12,704075,704775,700,0.45571428571428574
YLR283W,12,704472,705172,700,0.5042857142857143
ECI1,12,707088,707350,262,0.3511450381679389
NNT1,12,707087,707349,262,0.3511450381679389
CTS1,12,710367,710763,396,0.3838383838383838
YLR287C,12,712128,712339,211,0.3459715639810427
MEC3,12,714921,715059,138,0.34782608695652173
GUF1,12,714920,715058,138,0.34782608695652173
YLR290C,12,718000,718166,166,0.2891566265060241
GCD7,12,719494,719634,140,0.37857142857142856
SEC72,12,720389,720660,271,0.2952029520295203
GSP1,12,721467,721674,207,0.3526570048309179
YLR294C,12,722412,722414,2,1.0
ATP14,12,722414,723114,700,0.38142857142857145
YLR297W,12,723237,723937,700,0.4142857142857143
YHC1,12,725435,725876,441,0.36281179138321995
ECM38,12,725434,725875,441,0.36507936507936506
EXG1,12,728179,728856,677,0.4239290989660266
YLR301W,12,730552,730794,242,0.3925619834710744
MET17,12,731800,732500,700,0.34285714285714286
ACO1,12,737587,738043,456,0.44298245614035087
STT4,12,743923,744084,161,0.33540372670807456
UBC12,12,743922,744083,161,0.33540372670807456
CDA1,12,744960,745438,478,0.3179916317991632
IMH1,12,751802,751987,185,0.34594594594594597
CDC25,12,757155,757602,447,0.3288590604026846
YLR312C,12,758999,759468,469,0.4349680170575693
MRPL15,12,758998,759467,469,0.4349680170575693
SPH1,12,762394,762471,77,0.23376623376623376
CDC3,12,764202,764758,556,0.4010791366906475
NKP2,12,764201,764757,556,0.4010791366906475
TAD3,12,766389,766399,10,0.4
YLR317W,12,764757,764772,15,0.2
EST2,12,766388,766398,10,0.5
BUD6,12,771755,771911,156,0.34615384615384615
MMS22,12,771754,771910,156,0.33974358974358976
SFH1,12,777879,777999,120,0.3
CWC24,12,778979,779148,169,0.4437869822485207
PEX30,12,778978,779147,169,0.4437869822485207
RPL38,12,781400,782066,666,0.3633633633633634
YLR326W,12,781399,782065,666,0.3633633633633634
TMA10,12,783461,784161,700,0.45285714285714285
NMA1,12,784001,784701,700,0.4142857142857143
CHS5,12,786951,787651,700,0.3657142857142857
MID2,12,789823,790304,481,0.3887733887733888
RPS25B,12,796367,797067,700,0.3514285714285714
NUP2,12,796706,797406,700,0.3414285714285714
SGD1,12,802434,802528,94,0.32978723404255317
VRP1,12,805171,805827,656,0.33384146341463417
RPP0,12,805170,805826,656,0.33384146341463417
RPL26A,12,818594,819294,700,0.38857142857142857
YLR345W,12,820241,820439,198,0.4292929292929293
YLR346C,12,822653,823353,700,0.3557142857142857
KAP95,12,826533,826907,374,0.3663101604278075
DIC1,12,827892,828592,700,0.4785714285714286
ORM2,12,827948,828648,700,0.47285714285714286
NIT3,12,830379,831001,622,0.3858520900321543
YLR352W,12,830378,831000,622,0.387459807073955
BUD8,12,833635,833885,250,0.36
TAL1,12,837398,837848,450,0.4066666666666667
ILV5,12,839332,840032,700,0.4114285714285714
ATG33,12,839564,840264,700,0.41285714285714287
RSC2,12,841026,841274,248,0.3588709677419355
ADE13,12,843478,844178,700,0.3942857142857143
VPS38,12,845863,846028,165,0.296969696969697
DCR2,12,849145,849223,78,0.3076923076923077
STE11,12,849695,849826,131,0.3816793893129771
NMD4,12,853230,853449,219,0.2922374429223744
GRX8,12,853883,854011,128,0.359375
RPS22B,12,855136,855836,700,0.3657142857142857
MDM30,12,857372,857485,113,0.3274336283185841
SSQ1,12,859378,859439,61,0.39344262295081966
ARC18,12,862294,862520,226,0.40707964601769914
ROM2,12,862293,862519,226,0.40707964601769914
SUR4,12,867055,867209,154,0.3051948051948052
VID22,12,871383,871663,280,0.45357142857142857
STP3,12,871382,871662,280,0.45
PSY3,12,873588,873636,48,0.2916666666666667
FBP1,12,874828,875528,700,0.42714285714285716
SEC61,12,877383,878083,700,0.4514285714285714
CSR1,12,877488,878188,700,0.4542857142857143
CTF3,12,879642,879686,44,0.29545454545454547
NAM2,12,884833,885206,373,0.34584450402144773
SMC6,12,884832,885205,373,0.34584450402144773
IKI3,12,893420,893598,178,0.4157303370786517
SWC7,12,893420,893598,178,0.4157303370786517
VAC14,12,893419,893597,178,0.4157303370786517
REH1,12,897745,898121,376,0.39893617021276595
RPS29A,12,897744,898120,376,0.39893617021276595
STE23,12,902688,902865,177,0.4011299435028249
ECM19,12,902687,902864,177,0.3954802259887006
ART10,12,906476,907044,568,0.38204225352112675
ATP10,12,906475,907043,568,0.38028169014084506
CST9,12,907043,907056,13,0.3076923076923077
COX8,12,910010,910184,174,0.3620689655172414
VPS33,12,912358,912414,56,0.25
AFG2,12,914924,915059,135,0.32592592592592595
SKI2,12,919059,919201,142,0.38028169014084506
BDF1,12,921642,922342,700,0.4442857142857143
DUS3,12,924493,925193,700,0.4357142857142857
FLD1,12,928005,928705,700,0.2857142857142857
DUS4,12,929711,929781,70,0.24285714285714285
RPL31B,12,931781,932481,700,0.43714285714285717
YLR407W,12,932022,932722,700,0.4228571428571429
BLS1,12,934230,934363,133,0.3308270676691729
UTP21,12,937269,937490,221,0.28054298642533937
VIP1,12,937268,937489,221,0.28054298642533937
BER1,12,947644,948344,700,0.37285714285714283
YLR413W,12,950414,951114,700,0.36428571428571427
PUN1,12,954254,954783,529,0.499054820415879
YLR415C,12,954783,954923,140,0.4
VPS36,12,954782,954922,140,0.4
CDC73,12,958166,958367,201,0.3482587064676617
YLR419W,12,958165,958366,201,0.35323383084577115
URA4,12,963060,963760,700,0.3242857142857143
RPN13,12,965593,965747,154,0.37662337662337664
YLR422W,12,965592,965746,154,0.38311688311688313
ATG17,12,973206,973307,101,0.33663366336633666
SPP382,12,973205,973306,101,0.3465346534653465
TUS1,12,982022,982722,700,0.3628571428571429
YLR426W,12,986882,987036,154,0.34415584415584416
MAG2,12,988190,988333,143,0.3986013986013986
YLR428C,12,991034,991734,700,0.4042857142857143
CRN1,12,990607,990745,138,0.3115942028985507
SEN1,12,992867,993106,239,0.28451882845188287
ATG23,12,1001859,1002441,582,0.3436426116838488
IMD3,12,1001858,1002440,582,0.34536082474226804
CNA1,12,1006122,1006299,177,0.2768361581920904
TSR2,12,1006121,1006298,177,0.2768361581920904
ECM30,12,1011329,1011468,139,0.381294964028777
DIF1,12,1012079,1012466,387,0.49612403100775193
CAR2,12,1012078,1012465,387,0.49612403100775193
MRPL4,12,1014236,1014440,204,0.4117647058823529
SEC39,12,1017752,1017924,172,0.3313953488372093
RPS1A,12,1018936,1019216,280,0.36428571428571427
SIR3,12,1022324,1022488,164,0.27439024390243905
ECM7,12,1022323,1022487,164,0.27439024390243905
YLR446W,12,1024427,1025127,700,0.3385714285714286
VMA6,12,1027939,1028639,700,0.4
RPL6B,12,1028133,1028833,700,0.4157142857142857
FPR4,12,1030104,1030804,700,0.3628571428571429
HMG2,12,1032100,1032458,358,0.34916201117318435
LEU3,12,1035852,1036014,162,0.4074074074074074
SST2,12,1041538,1042238,700,0.34
RIF2,12,1043006,1043706,700,0.32285714285714284
FMP27,12,1043181,1043881,700,0.3385714285714286
YLR455W,12,1052692,1053392,700,0.32285714285714284
YLR456W,12,1054953,1055057,104,0.3269230769230769
NBP1,12,1056792,1057319,527,0.33586337760910817
GAB1,12,1056791,1057318,527,0.33586337760910817
YLR460C,12,1060933,1061633,700,0.3914285714285714
YPT7,13,266932,267080,148,0.42567567567567566
YML002W,13,263599,264299,700,0.35
GLO1,13,262700,263400,700,0.38285714285714284
TRM12,13,259513,260213,700,0.35428571428571426
GIS4,13,258570,259270,700,0.38285714285714284
YAP1,13,253282,253685,403,0.4392059553349876
ERG6,13,253024,253283,259,0.33976833976833976
SPT5,13,247455,247655,200,0.36
RAD33,13,247456,247656,200,0.365
ERV25,13,245378,246078,700,0.42714285714285716
UBX2,13,243426,244126,700,0.47
TRM9,13,243079,243214,135,0.31851851851851853
TAF11,13,243080,243215,135,0.31851851851851853
PPZ1,13,241797,241868,71,0.29577464788732394
PSP2,13,236087,236512,425,0.32941176470588235
YML018C,13,236088,236513,425,0.32941176470588235
OST6,13,233314,233443,129,0.3488372093023256
YML020W,13,230830,230963,133,0.3458646616541353
UNG1,13,230831,230964,133,0.3383458646616541
APT1,13,228701,228914,213,0.352112676056338
NSE5,13,228702,228915,213,0.352112676056338
RPS17A,13,225406,225862,456,0.4298245614035088
YML6,13,225407,225863,456,0.4298245614035088
RPS18B,13,223850,224300,450,0.4022222222222222
YOX1,13,220833,221330,497,0.4386317907444668
TSA1,13,219408,220108,700,0.4642857142857143
USA1,13,217145,217281,136,0.33088235294117646
AIM31,13,216231,216414,183,0.3825136612021858
NDC1,13,213969,214156,187,0.42245989304812837
RAD52,13,213970,214157,187,0.42780748663101603
SRC1,13,209023,209456,433,0.34872979214780603
AMD1,13,209024,209457,433,0.34872979214780603
CGI121,13,205454,205606,152,0.26973684210526316
YML037C,13,205455,205607,152,0.26973684210526316
YMD8,13,204250,204950,700,0.4
VPS71,13,195806,196506,700,0.3357142857142857
CAT2,13,192940,193640,700,0.38
RRN11,13,191928,192628,700,0.36428571428571427
PRP39,13,180685,181385,700,0.31857142857142856
GSF2,13,178188,178380,192,0.4375
RSE1,13,178189,178381,192,0.4375
AIM32,13,173043,173132,89,0.33707865168539325
GAL80,13,171414,171518,104,0.375
SUR7,13,169833,170367,534,0.41385767790262173
YML053C,13,169834,170368,534,0.4157303370786517
CYB2,13,167341,168041,700,0.42428571428571427
SPC2,13,164231,164753,522,0.3390804597701149
IMD4,13,164232,164754,522,0.3371647509578544
CMP2,13,159944,160096,152,0.3815789473684211
SML1,13,159097,159360,263,0.4600760456273764
NTE1,13,158317,158713,396,0.3207070707070707
OGG1,13,151681,151824,143,0.3356643356643357
PIF1,13,151682,151825,143,0.3356643356643357
MFT1,13,148715,148892,177,0.2994350282485876
RPS1B,13,145936,146455,519,0.4026974951830443
TEM1,13,145937,146456,519,0.4007707129094412
ORC1,13,141996,142115,119,0.3697478991596639
SMA2,13,141997,142116,119,0.3697478991596639
ERV41,13,140234,140934,700,0.39571428571428574
ITT1,13,137224,137484,260,0.3038461538461538
POB3,13,135298,135444,146,0.3904109589041096
DAK1,13,132724,133424,700,0.3842857142857143
COG8,13,131659,132359,700,0.3357142857142857
TCB3,13,129557,129705,148,0.36486486486486486
RPL6A,13,124197,124581,384,0.4244791666666667
FPR3,13,121356,122056,700,0.3442857142857143
HMG1,13,118976,119676,700,0.39285714285714285
WAR1,13,115363,115589,226,0.3584070796460177
BET5,13,111700,111823,123,0.3008130081300813
CPR3,13,110908,110976,68,0.23529411764705882
YML079W,13,110184,110237,53,0.3018867924528302
DUS1,13,108605,108685,80,0.25
YML081W,13,104220,104631,411,0.35279805352798055
YML082W,13,101106,101806,700,0.4442857142857143
TUB1,13,99449,100149,700,0.37285714285714283
ALO1,13,97527,97769,242,0.371900826446281
AIM33,13,95379,95677,298,0.31208053691275167
UFO1,13,91513,92213,700,0.4
RPM2,13,91029,91729,700,0.43
PRE8,13,86768,87117,349,0.20916905444126074
UTP14,13,82943,83070,127,0.3228346456692913
GIM5,13,82153,82257,104,0.33653846153846156
RAD10,13,82154,82258,104,0.33653846153846156
YML096W,13,79738,79884,146,0.3356164383561644
VPS9,13,79739,79885,146,0.3356164383561644
TAF13,13,77062,77242,180,0.38333333333333336
ARG81,13,77063,77243,180,0.37777777777777777
TSL1,13,70138,70233,95,0.4
CUE4,13,70139,70234,95,0.4105263157894737
CAC2,13,67588,68268,680,0.3941176470588235
NUP188,13,67589,68269,680,0.3926470588235294
MDM1,13,62360,62525,165,0.3939393939393939
SEC65,13,58717,58879,162,0.2654320987654321
URA5,13,56281,56467,186,0.3172043010752688
PML39,13,56282,56468,186,0.3172043010752688
YML108W,13,54547,54756,209,0.3157894736842105
ZDS2,13,50990,51586,596,0.3959731543624161
COQ5,13,50991,51587,596,0.39429530201342283
BUL2,13,46060,46760,700,0.39714285714285713
CTK3,13,44934,45035,101,0.2871287128712871
DAT1,13,43609,44006,397,0.33249370277078083
TAF8,13,43610,44007,397,0.33249370277078083
VAN1,13,41840,41978,138,0.32608695652173914
ATR1,13,37815,38114,299,0.3779264214046823
NAB6,13,33397,34097,700,0.40714285714285714
NGL3,13,31743,32232,489,0.3128834355828221
YML119W,13,29890,30590,700,0.38285714285714284
NDI1,13,29867,30567,700,0.37857142857142856
GTR1,13,26166,26866,700,0.36857142857142855
PHO84,13,25839,26539,700,0.4228571428571429
TUB3,13,23706,23896,190,0.4
PGA3,13,21722,21905,183,0.3005464480874317
ERG13,13,20484,20683,199,0.4472361809045226
RSC9,13,16777,16983,206,0.4368932038834951
MSC1,13,16778,16984,206,0.441747572815534
COX14,13,14767,14949,182,0.4065934065934066
ERO1,13,13271,13971,700,0.34714285714285714
YML131W,13,9457,10157,700,0.3142857142857143
CDC5,13,271487,272159,672,0.37797619047619047
MIC17,13,271486,272158,672,0.37797619047619047
AIM34,13,272906,273076,170,0.4294117647058823
MVP1,13,273788,273956,168,0.40476190476190477
TAF4,13,275699,275981,282,0.3404255319148936
PLB2,13,279739,279945,206,0.30097087378640774
YMR007W,13,279738,279944,206,0.2961165048543689
PLB1,13,282768,283468,700,0.42857142857142855
ADI1,13,283355,284055,700,0.4042857142857143
YMR010W,13,284738,284871,133,0.3007518796992481
HXT2,13,287340,288040,700,0.4142857142857143
CLU1,13,290317,291017,700,0.3442857142857143
SEC59,13,296808,297508,700,0.3157142857142857
BUD22,13,298474,298841,367,0.31607629427792916
ERG5,13,302539,303117,578,0.4013840830449827
SOK2,13,305817,306517,700,0.42428571428571427
STB4,13,311533,312233,700,0.31285714285714283
FMS1,13,314801,315275,474,0.35232067510548526
MAC1,13,318441,318660,219,0.4383561643835616
UBC7,13,318440,318659,219,0.4337899543378995
MSS1,13,321033,321733,700,0.34285714285714286
MRPL3,13,321181,321881,700,0.34
CSI1,13,323209,323287,78,0.3076923076923077
PEX12,13,325548,325799,251,0.4063745019920319
YMR027W,13,325547,325798,251,0.4103585657370518
TAP42,13,327345,327461,116,0.3017241379310345
FAR8,13,330269,330617,348,0.3936781609195402
RSF1,13,330268,330616,348,0.39080459770114945
YMR031C,13,334822,335220,398,0.4396984924623116
HOF1,13,334821,335219,398,0.4371859296482412
ARP9,13,337461,337744,283,0.2968197879858657
YMR034C,13,340930,341109,179,0.4581005586592179
IMP2,13,340929,341108,179,0.4581005586592179
MIH1,13,343562,344142,580,0.3586206896551724
MSN2,13,346982,347385,403,0.4392059553349876
CCS1,13,348290,348477,187,0.27807486631016043
SUB1,13,349662,350320,658,0.3799392097264438
YET2,13,349661,350319,658,0.378419452887538
ARA2,13,351991,352586,595,0.3831932773109244
ARG80,13,351990,352585,595,0.3831932773109244
MCM1,13,353592,353850,258,0.27906976744186046
IOC4,13,355060,355343,283,0.3003533568904594
NUP116,13,366780,366958,178,0.3258426966292135
CSM3,13,366779,366957,178,0.3202247191011236
ERB1,13,370551,371251,700,0.31
FAR3,13,378867,379567,700,0.35285714285714287
STV1,13,382388,383088,700,0.38285714285714284
BUB2,13,387050,387190,140,0.32142857142857145
AAC1,13,388325,388767,442,0.47285067873303166
FET3,13,388324,388766,442,0.47285067873303166
SEN15,13,390876,391060,184,0.33152173913043476
RNA14,13,392535,392730,195,0.30256410256410254
ARG7,13,396395,397020,625,0.3968
RIM9,13,397019,397039,20,0.3
AEP1,13,396394,397019,625,0.3968
KAR5,13,399571,399865,294,0.3197278911564626
SOV1,13,401289,401545,256,0.37109375
UBX4,13,405600,406293,693,0.3347763347763348
AVO2,13,405599,406292,693,0.3347763347763348
NAT4,13,407680,407761,81,0.345679012345679
MOT3,13,408245,408945,700,0.5057142857142857
TVP18,13,411328,411547,219,0.3515981735159817
ABF2,13,411327,411546,219,0.3561643835616438
IRC21,13,412907,412965,58,0.27586206896551724
YMR074C,13,413485,413930,445,0.3887640449438202
RCO1,13,413484,413929,445,0.39101123595505616
VPS20,13,422205,422399,194,0.4020618556701031
CTF18,13,424741,424954,213,0.3615023474178404
SEC14,13,424740,424953,213,0.3615023474178404
NAM7,13,429706,429829,123,0.37398373983739835
ISF1,13,431242,431942,700,0.38571428571428573
ADH3,13,434033,434733,700,0.41714285714285715
YMR085W,13,436501,437201,700,0.3585714285714286
YMR086W,13,438833,439138,305,0.4262295081967213
YMR087W,13,442227,442473,246,0.34959349593495936
VBA1,13,445217,445430,213,0.4460093896713615
YTA12,13,448285,448985,700,0.38857142857142857
YMR090W,13,448498,449198,700,0.3871428571428571
NPL6,13,451406,451559,153,0.30718954248366015
AIP1,13,453561,453965,404,0.35396039603960394
UTP15,13,453560,453964,404,0.35148514851485146
CTF13,13,455658,455814,156,0.3717948717948718
SNO1,13,457982,458368,386,0.40932642487046633
SNZ1,13,457981,458367,386,0.40932642487046633
MTG1,13,460567,460697,130,0.35384615384615387
ATP25,13,462684,463384,700,0.3142857142857143
YMR099C,13,464847,465547,700,0.36714285714285716
MUB1,13,465245,465945,700,0.37285714285714283
YMR102C,13,472682,472756,74,0.3783783783783784
YMR103C,13,475227,475522,295,0.376271186440678
YPK2,13,475522,475747,225,0.3111111111111111
PGM2,13,477665,478174,509,0.45579567779960706
YKU80,13,480239,480939,700,0.3457142857142857
SPG4,13,482253,482953,700,0.4114285714285714
ILV2,13,483553,483887,334,0.37425149700598803
MYO5,13,486307,486545,238,0.31092436974789917
HFD1,13,492011,492239,228,0.31140350877192985
YMR111C,13,493874,493979,105,0.29523809523809524
MED11,13,494607,494942,335,0.3253731343283582
FOL3,13,494606,494941,335,0.32238805970149254
YMR114C,13,497472,497656,184,0.3532608695652174
MGR3,13,497471,497655,184,0.3532608695652174
ASC1,13,500717,501417,700,0.34285714285714286
SPC24,13,501919,502142,223,0.35874439461883406
YMR118C,13,502774,503474,700,0.3271428571428571
ASI1,13,504447,505147,700,0.3357142857142857
ADE17,13,509323,509681,358,0.35195530726256985
RPL15B,13,510383,510684,301,0.3953488372093023
YMR122C,13,511754,511814,60,0.15
PKR1,13,512856,513556,700,0.3757142857142857
YMR124W,13,514048,514185,137,0.35766423357664234
STO1,13,517273,517463,190,0.3105263157894737
DLT1,13,522005,522121,116,0.39655172413793105
SAS2,13,523441,523650,209,0.3253588516746411
ECM16,13,523440,523649,209,0.3253588516746411
POM152,13,527575,527760,185,0.2648648648648649
YMR130W,13,531922,532042,120,0.35
RRB1,13,534743,535443,700,0.3457142857142857
JLP2,13,535657,536357,700,0.2985714285714286
YMR134W,13,537098,537798,700,0.3585714285714286
GID8,13,540110,540810,700,0.49142857142857144
GAT2,13,540421,541121,700,0.42857142857142855
PSO2,13,545003,545138,135,0.3111111111111111
CIN4,13,545002,545137,135,0.3111111111111111
RIM11,13,545805,545910,105,0.49523809523809526
SIP5,13,547446,547667,221,0.3574660633484163
RPL13B,13,551230,551907,677,0.4076809453471196
RPS16A,13,551229,551906,677,0.4076809453471196
YMR144W,13,552985,553245,260,0.3423076923076923
NDE1,13,556611,557311,700,0.44571428571428573
TIF34,13,558562,559175,613,0.3539967373572594
YMR147W,13,558561,559174,613,0.3539967373572594
OSW5,13,558561,559174,613,0.3539967373572594
SWP1,13,560237,560937,700,0.39714285714285713
IMP1,13,562926,563082,156,0.358974358974359
YIM1,13,562925,563081,156,0.358974358974359
NUP53,13,564266,564382,116,0.33620689655172414
RIM13,13,568228,568529,301,0.3289036544850498
YMR155W,13,568227,568528,301,0.3289036544850498
TPP1,13,571033,571153,120,0.35
AIM36,13,572074,572192,118,0.3728813559322034
MRPS8,13,572073,572191,118,0.3728813559322034
ATG16,13,574910,575019,109,0.3394495412844037
YMR160W,13,574909,575018,109,0.3302752293577982
HLJ1,13,577558,577668,110,0.44545454545454544
DNF3,13,584094,584207,113,0.415929203539823
INP2,13,586533,586910,377,0.36074270557029176
MSS11,13,589710,589934,224,0.36160714285714285
PAH1,13,592747,593137,390,0.44871794871794873
YMR166C,13,594725,594878,153,0.35294117647058826
MLH1,13,594724,594877,153,0.35294117647058826
CEP3,13,599199,599297,98,0.37755102040816324
ALD2,13,603108,603615,507,0.38461538461538464
EAR1,13,605716,606114,398,0.35175879396984927
HOT1,13,605715,606113,398,0.35175879396984927
DDR48,13,608177,608642,465,0.37849462365591396
ECM5,13,611281,611637,356,0.3595505617977528
MMT1,13,616031,616428,397,0.4005037783375315
YMR178W,13,618181,618442,261,0.2835249042145594
SPT21,13,619449,619701,252,0.36904761904761907
CTL1,13,623238,623328,90,0.26666666666666666
YMR181C,13,624273,624973,700,0.47
RGM1,13,625280,625980,700,0.3414285714285714
SSO2,13,627885,628141,256,0.42578125
ADD37,13,627884,628140,256,0.42578125
YMR185W,13,628827,629002,175,0.32571428571428573
HSC82,13,632028,632327,299,0.36454849498327757
YMR187C,13,636006,636174,168,0.32142857142857145
MRPS17,13,637078,637394,316,0.41139240506329117
GCV2,13,637077,637393,316,0.41139240506329117
SGS1,13,645422,645642,220,0.41818181818181815
SPG5,13,645421,645641,220,0.41363636363636364
GYL1,13,646913,647028,115,0.28695652173913044
MRPL24,13,649359,650004,645,0.33178294573643413
RPL36A,13,650934,651124,190,0.3105263157894737
ICY1,13,653241,653941,700,0.44857142857142857
YMR196W,13,654541,655041,500,0.386
VTI1,13,659236,659465,229,0.3056768558951965
CIK1,13,659235,659464,229,0.31004366812227074
CLN1,13,661745,662445,700,0.4514285714285714
ROT1,13,664401,664630,229,0.3318777292576419
RAD14,13,667062,667512,450,0.40444444444444444
ERG2,13,667061,667511,450,0.4066666666666667
TOM40,13,668270,668448,178,0.3202247191011236
INP1,13,671356,671713,357,0.2773109243697479
PFK2,13,674821,675521,700,0.3628571428571429
YMR206W,13,675021,675721,700,0.39571428571428574
HFA1,13,684006,684449,443,0.3927765237020316
ERG12,13,684005,684448,443,0.3927765237020316
YMR209C,13,687317,687485,168,0.2976190476190476
YMR210W,13,687316,687484,168,0.2976190476190476
DML1,13,688923,689064,141,0.28368794326241137
EFR3,13,693181,693340,159,0.3584905660377358
CEF1,13,693180,693339,159,0.3584905660377358
SCJ1,13,695189,695321,132,0.4696969696969697
GAS3,13,696605,696721,116,0.25
SKY1,13,701211,701729,518,0.3416988416988417
GUA1,13,701210,701728,518,0.33976833976833976
TRS130,13,706934,707082,148,0.3310810810810811
ESC1,13,706933,707081,148,0.33783783783783783
ERG8,13,712065,712305,240,0.3333333333333333
YMR221C,13,715458,715554,96,0.34375
FSH2,13,716337,716497,160,0.28125
UBP8,13,716336,716496,160,0.28125
MRE11,13,720701,720791,90,0.3333333333333333
MRPL44,13,721424,721532,108,0.39814814814814814
YMR226C,13,722446,722505,59,0.3898305084745763
TAF7,13,724432,724597,165,0.3212121212121212
MTF1,13,724431,724596,165,0.3212121212121212
RRP5,13,731222,731922,700,0.3442857142857143
RPS10B,13,731681,732381,700,0.34285714285714286
PEP5,13,733233,733492,259,0.30115830115830117
TRI1,13,738439,739139,700,0.32857142857142857
RNH1,13,740037,740192,155,0.2709677419354839
RNA1,13,742772,742961,189,0.3386243386243386
TAF9,13,742771,742960,189,0.3386243386243386
BCH1,13,743554,743677,123,0.36585365853658536
DFG5,13,746085,746224,139,0.3237410071942446
RNT1,13,749735,749878,143,0.38461538461538464
CUS1,13,751298,751816,518,0.3687258687258687
YHM2,13,751297,751815,518,0.3687258687258687
RPL20A,13,754243,754661,418,0.41626794258373206
ZRC1,13,756277,756977,700,0.39
FAA4,13,758879,759579,700,0.45714285714285713
RKR1,13,768094,768794,700,0.33714285714285713
GAD1,13,770057,770757,700,0.36714285714285716
GTO3,13,772667,773313,646,0.43034055727554177
YMR252C,13,775762,775920,158,0.3924050632911392
YMR253C,13,777241,777941,700,0.38285714285714284
GFD1,13,777247,777947,700,0.3871428571428571
PET111,13,782419,782587,168,0.32142857142857145
YMR258C,13,784334,784571,237,0.3206751054852321
YMR259C,13,788942,789218,276,0.32971014492753625
TIF11,13,789864,790060,196,0.29081632653061223
TPS3,13,793458,793671,213,0.4507042253521127
YMR262W,13,793457,793670,213,0.4507042253521127
SAP30,13,794886,794889,3,0.3333333333333333
CUE1,13,795593,795758,165,0.3878787878787879
YMR265C,13,797928,798484,556,0.40467625899280574
RSN1,13,797927,798483,556,0.4028776978417266
PPA2,13,801564,801697,133,0.3458646616541353
PRP24,13,804264,804417,153,0.2875816993464052
TMA23,13,804263,804416,153,0.28104575163398693
RRN9,13,806564,806708,144,0.2986111111111111
URA10,13,807613,808313,700,0.35714285714285715
SCS7,13,810816,811158,342,0.41812865497076024
RCE1,13,815358,815524,166,0.26506024096385544
BUL1,13,818627,818799,172,0.43023255813953487
DSK2,13,818626,818798,172,0.436046511627907
FCP1,13,820055,820136,81,0.345679012345679
PGM3,13,822581,822722,141,0.23404255319148937
YMR279C,13,826381,826942,561,0.39037433155080214
CAT8,13,831438,832138,700,0.35428571428571426
GPI12,13,831564,832264,700,0.35714285714285715
AEP2,13,835145,835270,125,0.32
RIT1,13,836846,837546,700,0.3485714285714286
YKU70,13,837460,838160,700,0.3157142857142857
NGL2,13,841699,841925,226,0.3407079646017699
DSS1,13,845414,845550,136,0.34558823529411764
HSH155,13,845413,845549,136,0.35294117647058826
ABZ2,13,848539,848666,127,0.3543307086614173
HAS1,13,851622,852322,700,0.3757142857142857
YMR291W,13,851851,852551,700,0.39285714285714285
GOT1,13,854567,854772,205,0.4097560975609756
HER2,13,856823,856939,116,0.35344827586206895
JNM1,13,856822,856938,116,0.35344827586206895
YMR295C,13,858945,859131,186,0.3870967741935484
LCB1,13,860998,861698,700,0.37
PRC1,13,861149,861849,700,0.40285714285714286
LIP1,13,863631,863796,165,0.3090909090909091
DYN3,13,865369,865478,109,0.23853211009174313
ADE4,13,867170,867501,331,0.32628398791540786
ATM1,13,869676,869972,296,0.38175675675675674
YME2,13,872677,873204,527,0.3984819734345351
ADH2,13,874392,874786,394,0.3730964467005076
UBP15,13,874391,874785,394,0.37055837563451777
SCW10,13,880357,881057,700,0.3942857142857143
GAS1,13,886267,886967,700,0.38
PSE1,13,892371,892760,389,0.26735218508997427
NIP1,13,895485,895648,163,0.3619631901840491
YMR310C,13,896708,896789,81,0.4444444444444444
GLC8,13,897642,898342,700,0.3385714285714286
ELP6,13,897682,898382,700,0.3442857142857143
TGL3,13,901341,901666,325,0.3169230769230769
PRE5,13,901340,901665,325,0.31384615384615383
YMR315W,13,902570,902757,187,0.39572192513368987
DIA1,13,904060,904760,700,0.42714285714285716
ADH6,13,912187,912654,467,0.41113490364025695
FET4,13,914642,915342,700,0.3842857142857143
YMR320W,13,914795,915495,700,0.4014285714285714
DOM34,14,627160,627400,240,0.31666666666666665
RLP7,14,627161,627401,240,0.32083333333333336
PET8,14,625861,626109,248,0.375
HRB1,14,622477,622888,411,0.35279805352798055
MRP7,14,622478,622889,411,0.35279805352798055
LST8,14,619703,620049,346,0.3468208092485549
SIS1,14,619704,620050,346,0.3468208092485549
ASI3,14,618268,618455,187,0.37967914438502676
IDP3,14,615166,615866,700,0.37
YNL010W,14,613203,613595,392,0.33418367346938777
YNL011C,14,613204,613596,392,0.33163265306122447
SPO1,14,609434,609676,242,0.2396694214876033
HEF3,14,605778,606138,360,0.4
PBI2,14,604614,605314,700,0.4057142857142857
PUB1,14,602153,602853,700,0.38
ARK1,14,597667,598367,700,0.3871428571428571
HDA1,14,592923,593156,233,0.3605150214592275
YNL022C,14,592924,593157,233,0.3648068669527897
FAP1,14,591209,591332,123,0.35772357723577236
YNL024C,14,587866,588186,320,0.346875
SSN8,14,585318,586018,700,0.3457142857142857
SAM50,14,581720,581900,180,0.31666666666666665
CRZ1,14,578817,579472,655,0.4030534351145038
KTR5,14,578818,579473,655,0.40458015267175573
HHF2,14,576065,576696,631,0.43423137876386686
HHT2,14,576066,576697,631,0.43423137876386686
SIW14,14,573665,574365,700,0.4057142857142857
YNL035C,14,569723,570423,700,0.41
NCE103,14,559114,559762,648,0.39969135802469136
IDH1,14,559115,559763,648,0.39969135802469136
GPI15,14,556889,557008,119,0.36134453781512604
BDP1,14,554902,555010,108,0.25925925925925924
YNL040W,14,552650,553350,700,0.33714285714285713
COG6,14,552042,552742,700,0.34
BOP3,14,546634,547334,700,0.3942857142857143
YNL043C,14,546026,546040,14,0.42857142857142855
YIP3,14,545119,545196,77,0.23376623376623376
LAP2,14,542252,542952,700,0.4342857142857143
YNL046W,14,541909,542117,208,0.42788461538461536
SLM2,14,541910,542118,208,0.42788461538461536
ALG11,14,537924,538145,221,0.38009049773755654
SFB2,14,537925,538146,221,0.38009049773755654
YNL050C,14,535010,535179,169,0.3136094674556213
COG5,14,532444,532652,208,0.3076923076923077
COX5A,14,531544,531693,149,0.4161073825503356
MSG5,14,529642,529821,179,0.2569832402234637
VAC7,14,525326,526026,700,0.39
POR1,14,518884,519584,700,0.4
OCA2,14,516743,517215,472,0.3093220338983051
YNL058C,14,516744,517216,472,0.3072033898305085
ARP5,14,514951,515651,700,0.35285714285714287
NOP2,14,510254,510521,267,0.31835205992509363
GCD10,14,510255,510522,267,0.3146067415730337
MTQ1,14,507289,507633,344,0.32848837209302323
YDJ1,14,507290,507634,344,0.32848837209302323
AQR1,14,502974,503630,656,0.40853658536585363
SUN4,14,500485,500961,476,0.3382352941176471
RPL9B,14,498947,499647,700,0.3485714285714286
FKH2,14,498499,499199,700,0.3557142857142857
RPL16B,14,495016,495531,515,0.42135922330097086
TOM7,14,493125,493291,166,0.3373493975903614
LAT1,14,491322,491484,162,0.5
RNH201,14,490208,490295,87,0.3333333333333333
MSK1,14,488169,488368,199,0.3869346733668342
MLF3,14,488170,488369,199,0.38190954773869346
IMP4,14,485370,485547,177,0.3446327683615819
MKS1,14,483067,483286,219,0.4063926940639269
APJ1,14,481140,481223,83,0.37349397590361444
NIS1,14,479204,479758,554,0.36823104693140796
TPM1,14,479205,479759,554,0.36823104693140796
EOS1,14,478204,478386,182,0.45054945054945056
SWS2,14,476653,476832,179,0.31843575418994413
PMS1,14,473143,473343,200,0.285
SAL1,14,471155,471346,191,0.29842931937172773
END3,14,471156,471347,191,0.29842931937172773
MKT1,14,466729,466864,135,0.32592592592592595
SNN1,14,466151,466241,90,0.37777777777777777
TCB2,14,462176,462304,128,0.3203125
TOP2,14,457500,457632,132,0.3712121212121212
RHO2,14,456201,456405,204,0.39705882352941174
NST1,14,452142,452266,124,0.3951612903225806
YNL092W,14,450099,450799,700,0.3914285714285714
YPT53,14,449448,449736,288,0.3715277777777778
APP1,14,447022,447335,313,0.4440894568690096
YNL095C,14,447023,447336,313,0.44089456869009586
RPS7B,14,444356,444725,369,0.3875338753387534
PHO23,14,442466,443166,700,0.38
RAS2,14,440652,441246,594,0.45286195286195285
OCA1,14,439316,439482,166,0.3614457831325301
AIM37,14,437335,437570,235,0.33617021276595743
AVT4,14,434552,434811,259,0.3861003861003861
POL1,14,429836,430000,164,0.32926829268292684
MET4,14,427109,427578,469,0.4626865671641791
LEU4,14,426877,427110,233,0.4291845493562232
INP52,14,424589,424779,190,0.34210526315789475
YAF9,14,419884,420075,191,0.3717277486910995
YNL108C,14,419864,419885,21,0.38095238095238093
YNL109W,14,418860,418868,8,0.375
NOP15,14,418526,418861,335,0.3761194029850746
CYB5,14,417333,417710,377,0.3183023872679045
DBP2,14,413377,413597,220,0.2590909090909091
RPC19,14,412075,412728,653,0.3430321592649311
YNL115C,14,412076,412729,653,0.3430321592649311
DMA2,14,408088,408287,199,0.35678391959798994
MLS1,14,405616,406304,688,0.373546511627907
DCP2,14,405617,406305,688,0.373546511627907
NCS2,14,400584,401031,447,0.32662192393736017
TOM70,14,400585,401032,447,0.32662192393736017
YNL122C,14,398357,398461,104,0.3269230769230769
NMA111,14,394474,394651,177,0.288135593220339
NAF1,14,392361,392863,502,0.4402390438247012
ESBP6,14,392362,392864,502,0.43824701195219123
SPC98,14,387040,387171,131,0.3053435114503817
FAR11,14,383196,383896,700,0.38142857142857145
NRK1,14,380872,381435,563,0.33747779751332146
CPT1,14,380873,381436,563,0.3392539964476021
TOM22,14,378577,378719,142,0.3873239436619718
KRE33,14,374722,375229,507,0.3905325443786982
FYV6,14,374723,375230,507,0.3905325443786982
YNL134C,14,373626,374057,431,0.42923433874709976
FPR1,14,372255,372400,145,0.42758620689655175
EAF7,14,370148,370345,197,0.4010152284263959
NAM9,14,370149,370346,197,0.4010152284263959
SRV2,14,366614,366714,100,0.38
YNL140C,14,362162,362862,700,0.35
AAH1,14,359024,359570,546,0.29853479853479853
MEP2,14,356427,357127,700,0.37857142857142856
YNL144C,14,355157,355857,700,0.4342857142857143
MFA2,14,352326,352369,43,0.4418604651162791
YNL146W,14,351430,351610,180,0.37777777777777777
LSM7,14,350681,350872,191,0.38219895287958117
ALF1,14,350682,350873,191,0.38219895287958117
PGA2,14,349779,350479,700,0.5057142857142857
RPC31,14,348571,349261,690,0.3898550724637681
INN1,14,346085,346286,201,0.39800995024875624
GIM3,14,346086,346287,201,0.40298507462686567
YCK2,14,345498,346086,588,0.3945578231292517
YNL155W,14,342138,342409,271,0.4022140221402214
NSG2,14,342139,342410,271,0.4022140221402214
IGO1,14,339578,340278,700,0.41
PGA1,14,339367,339575,208,0.3701923076923077
ASI2,14,339368,339576,208,0.3701923076923077
YGP1,14,335789,336489,700,0.4
CBK1,14,332243,332456,213,0.4131455399061033
RPL42A,14,330921,331294,373,0.44235924932975873
RIA1,14,330138,330312,174,0.3333333333333333
IBD2,14,326485,326620,135,0.4148148148148148
YNL165W,14,323574,323754,180,0.32222222222222224
BNI5,14,323575,323755,180,0.32222222222222224
SKO1,14,321703,322106,403,0.3325062034739454
FMP41,14,318843,319199,356,0.36797752808988765
PSD1,14,317778,317874,96,0.3854166666666667
MDG1,14,310105,310805,700,0.38142857142857145
NOP13,14,308648,308862,214,0.37383177570093457
YNL176C,14,307159,307280,121,0.371900826446281
MRPL22,14,304664,304819,155,0.4258064516129032
RPS3,14,301961,302661,700,0.36714285714285716
RHO5,14,300841,301541,700,0.39
YNL181W,14,297680,298265,585,0.39316239316239315
IPI3,14,297681,298266,585,0.39316239316239315
NPR1,14,295706,295875,169,0.41420118343195267
MRPL19,14,292766,293030,264,0.29924242424242425
UBP10,14,289303,289344,41,0.3902439024390244
SWT21,14,287630,287799,169,0.378698224852071
KAR1,14,286008,286209,201,0.31343283582089554
SRP1,14,283607,284067,460,0.3391304347826087
YNL190W,14,281589,282154,565,0.36991150442477877
DUG3,14,279985,280345,360,0.32222222222222224
CHS1,14,276096,276345,249,0.3815261044176707
YNL193W,14,273701,274343,642,0.40498442367601245
YNL194C,14,273702,274344,642,0.40342679127725856
YNL195C,14,272398,272486,88,0.25
WHI3,14,269931,270631,700,0.39285714285714285
GCR2,14,266658,266917,259,0.3359073359073359
YNL200C,14,264557,264750,193,0.37305699481865284
PSY2,14,263480,263633,153,0.33986928104575165
SPS19,14,258857,259557,700,0.3657142857142857
RTT106,14,258164,258864,700,0.38285714285714284
RIO2,14,255125,255227,102,0.37254901960784315
YNL208W,14,254018,254398,380,0.41842105263157897
SSB2,14,251335,252035,700,0.33714285714285713
YNL211C,14,250366,251066,700,0.3485714285714286
VID27,14,247191,247400,209,0.3588516746411483
RRG9,14,247192,247401,209,0.35406698564593303
PEX17,14,245488,245595,107,0.37383177570093457
IES2,14,244307,244408,101,0.3465346534653465
RAP1,14,241415,241605,190,0.4052631578947368
YNL217W,14,240176,240303,127,0.4015748031496063
MGS1,14,237808,238039,231,0.38095238095238093
ALG9,14,237809,238040,231,0.3852813852813853
ADE12,14,233756,234321,565,0.35752212389380533
POP1,14,233757,234322,565,0.35752212389380533
SSU72,14,228921,229056,135,0.362962962962963
ATG4,14,227187,227365,178,0.34269662921348315
SQS1,14,227188,227366,178,0.34269662921348315
CNM67,14,224518,224659,141,0.3617021276595745
JJJ1,14,222484,222618,134,0.29850746268656714
URE2,14,220414,220587,173,0.4161849710982659
ELA1,14,218725,218974,249,0.321285140562249
PDR16,14,217190,217890,700,0.4514285714285714
CSL4,14,214681,214876,195,0.3384615384615385
BNI4,14,211643,211745,102,0.3431372549019608
YNL234W,14,209944,210199,255,0.4470588235294118
SIN4,14,206750,206885,135,0.34074074074074073
YTP1,14,205003,205118,115,0.391304347826087
KEX2,14,202062,202153,91,0.27472527472527475
LAP3,14,199997,200510,513,0.3996101364522417
NAR1,14,199998,200511,513,0.4015594541910331
ZWF1,14,198058,198392,334,0.4431137724550898
ATG2,14,191042,191185,143,0.4195804195804196
SLA2,14,187528,187997,469,0.3837953091684435
SUI1,14,187529,187998,469,0.3837953091684435
CWC25,14,186904,187026,122,0.4426229508196721
VPS75,14,185279,185452,173,0.31213872832369943
YNL247W,14,182648,182870,222,0.36486486486486486
RPA49,14,182649,182871,222,0.36486486486486486
MPA43,14,181044,181160,116,0.2672413793103448
RAD50,14,174685,175385,700,0.37142857142857144
NRD1,14,174587,175287,700,0.38
MRPL17,14,172306,172444,138,0.2391304347826087
TEX1,14,169293,169985,692,0.3468208092485549
RTC4,14,169294,169986,692,0.3453757225433526
GIS2,14,167815,168515,700,0.4042857142857143
FOL1,14,164397,164570,173,0.3236994219653179
SIP3,14,164398,164571,173,0.3179190751445087
DSL1,14,160381,160646,265,0.30566037735849055
ATX1,14,157886,157995,109,0.3761467889908257
YNL260C,14,157382,157554,172,0.23255813953488372
ORC5,14,154913,155053,140,0.22142857142857142
POL2,14,147982,148193,211,0.36018957345971564
YIF1,14,147983,148194,211,0.36492890995260663
PDR17,14,146631,146788,157,0.2929936305732484
IST1,14,145302,145421,119,0.3025210084033613
PIK1,14,140521,140769,248,0.3467741935483871
LYP1,14,137846,138494,648,0.41975308641975306
ALP1,14,137847,138495,648,0.41975308641975306
BNI1,14,135670,135846,176,0.4090909090909091
SEC2,14,129180,129390,210,0.37142857142857144
TOF1,14,122230,122842,612,0.42320261437908496
GOR1,14,122231,122843,612,0.42483660130718953
BOR1,14,118927,119250,323,0.3591331269349845
YNL276C,14,118898,118928,30,0.23333333333333334
MET2,14,117106,117238,132,0.3333333333333333
CAF120,14,112454,113154,700,0.41
ERG24,14,110484,111184,700,0.36857142857142855
HCH1,14,107718,108418,700,0.4357142857142857
POP3,14,107087,107646,559,0.39892665474060823
WSC2,14,107088,107647,559,0.39713774597495527
MRPL10,14,104063,104763,700,0.3657142857142857
CUS2,14,95032,95116,84,0.3333333333333333
SEC21,14,91575,91804,229,0.37117903930131
CAF40,14,89466,90166,700,0.36428571428571427
PCL1,14,87320,87825,505,0.4178217821782178
RFC3,14,86020,86209,189,0.3333333333333333
MID1,14,86021,86210,189,0.3333333333333333
PUS4,14,82637,82796,159,0.3270440251572327
MSB3,14,80438,80575,137,0.3795620437956204
RIM21,14,80439,80576,137,0.3795620437956204
YNL295W,14,76622,76808,186,0.41397849462365593
MON2,14,76623,76809,186,0.41397849462365593
CLA4,14,68507,68722,215,0.4
TRF5,14,66307,66432,125,0.344
TOS6,14,64951,65651,700,0.4085714285714286
RPL18B,14,64586,65286,700,0.3657142857142857
RPS19B,14,62964,63410,446,0.4192825112107623
YPT11,14,59821,60246,425,0.4423529411764706
YNL305C,14,59822,60247,425,0.4423529411764706
MRPS18,14,57735,58128,393,0.4071246819338422
MCK1,14,57736,58129,393,0.4071246819338422
KRI1,14,55934,56106,172,0.3023255813953488
STB1,14,52462,52596,134,0.3656716417910448
ZIM17,14,52463,52597,134,0.3656716417910448
SKP2,14,51702,51818,116,0.3793103448275862
RFA2,14,48036,48247,211,0.3459715639810427
EMW1,14,48037,48248,211,0.3459715639810427
DAL82,14,44300,44415,115,0.3652173913043478
ATP11,14,44301,44416,115,0.3652173913043478
PHA2,14,43131,43215,84,0.25
PFS2,14,39907,40607,700,0.34
YNL320W,14,37548,37642,94,0.39361702127659576
VNX1,14,34261,34675,414,0.3333333333333333
KRE1,14,34262,34676,414,0.3333333333333333
LEM3,14,31403,31888,485,0.35051546391752575
FIG4,14,31404,31889,485,0.34845360824742266
PFA3,14,28389,28681,292,0.2705479452054795
EGT2,14,23356,24016,660,0.37727272727272726
MDJ2,14,23357,24017,660,0.37575757575757573
RPD3,14,19357,20057,700,0.3871428571428571
AAD14,14,17752,17867,115,0.3391304347826087
CIT1,14,631161,631206,45,0.35555555555555557
ATO2,14,633886,634244,358,0.44972067039106145
RPC34,14,635326,635917,591,0.311336717428088
SWM2,14,635325,635916,591,0.3130287648054145
VPS27,14,636788,636957,169,0.34911242603550297
ATG3,14,640142,640348,206,0.34951456310679613
LRO1,14,640141,640347,206,0.34951456310679613
NRM1,14,642625,642647,22,0.6363636363636364
CSE2,14,643601,643711,110,0.37272727272727274
PRP2,14,646960,647351,391,0.3375959079283887
URK1,14,646959,647350,391,0.3375959079283887
PHO91,14,651755,652420,665,0.40902255639097745
YNR014W,14,651754,652419,665,0.4075187969924812
SMM1,14,653271,653366,95,0.37894736842105264
ACC1,14,662454,662729,275,0.3563636363636364
TIM23,14,662453,662728,275,0.3563636363636364
AIM38,14,663737,664219,482,0.4045643153526971
ARE2,14,665069,665297,228,0.3815789473684211
ATP23,14,668142,668350,208,0.28846153846153844
YNR021W,14,668141,668349,208,0.28846153846153844
MRPL50,14,670218,670378,160,0.275
SNF12,14,670217,670377,160,0.275
MPP6,14,672210,672392,182,0.3516483516483517
SEC12,14,674725,674877,152,0.2894736842105263
BUD17,14,674724,674876,152,0.2894736842105263
CPR8,14,675405,676105,700,0.4142857142857143
YNR029C,14,678520,678738,218,0.29357798165137616
ALG12,14,678519,678737,218,0.29357798165137616
SSK2,14,685718,685905,187,0.40641711229946526
PPG1,14,685717,685904,187,0.40106951871657753
ABZ1,14,687494,687628,134,0.4552238805970149
SOL1,14,690066,690208,142,0.323943661971831
ARC35,14,694055,694199,144,0.3819444444444444
MRPS12,14,694832,694933,101,0.45544554455445546
RSM19,14,695357,695591,234,0.41452991452991456
DBP6,14,695356,695590,234,0.41025641025641024
ZRG17,14,699474,699685,211,0.32701421800947866
YNR040W,14,699473,699684,211,0.32701421800947866
COQ2,14,701690,701876,186,0.3978494623655914
MVD1,14,701689,701875,186,0.3924731182795699
AGA1,14,703231,703581,350,0.36857142857142855
PET494,14,705944,706107,163,0.3312883435582822
TRM112,14,707656,707769,113,0.37168141592920356
FPK1,14,708322,708457,135,0.45185185185185184
YNR048W,14,711462,711574,112,0.3392857142857143
MSO1,14,713675,713935,260,0.36538461538461536
LYS9,14,715427,716127,700,0.36142857142857143
BRE5,14,719068,719295,227,0.3920704845814978
POP2,14,720741,720932,191,0.3403141361256545
NOG2,14,723146,723312,166,0.3192771084337349
ESF2,14,724340,725040,700,0.35428571428571426
HOL1,14,730640,731340,700,0.30428571428571427
BIO5,14,733415,734025,610,0.4704918032786885
BIO4,14,734172,734872,700,0.41
BIO3,14,733414,734024,610,0.46885245901639344
MNT4,14,736009,736709,700,0.39
FRE4,14,739220,739920,700,0.4
YNR061C,14,743626,744168,542,0.3191881918819188
YNR062C,14,744976,745676,700,0.37285714285714283
YNR063W,14,746183,746883,700,0.34714285714285714
YNR064C,14,750032,750732,700,0.39285714285714285
DSE4,14,759145,759845,700,0.3628571428571429
BSC5,14,762750,763450,700,0.37
PDR18,14,768335,769035,700,0.36
YNR071C,14,771664,772364,700,0.38285714285714284
YNR073C,14,776344,777044,700,0.4
AIF1,14,779200,779900,700,0.34
COS10,14,778423,779123,700,0.38142857142857145
PHO80,15,324370,324416,46,0.34782608695652173
IZH2,15,324371,324417,46,0.3695652173913043
PFA4,15,323016,323337,321,0.3364485981308411
SIN3,15,316211,316728,517,0.4332688588007737
RPB11,15,316212,316729,517,0.4332688588007737
TOP1,15,315469,315762,293,0.3037542662116041
CSI2,15,312452,312919,467,0.39400428265524623
COQ10,15,310162,310284,122,0.3360655737704918
MDM12,15,310163,310285,122,0.3360655737704918
RCL1,15,307686,307892,206,0.3640776699029126
PLB3,15,304087,304601,514,0.45330739299610895
HTZ1,15,304088,304602,514,0.45330739299610895
HRD1,15,303187,303419,232,0.34913793103448276
YOL014W,15,299071,299504,433,0.3533487297921478
IRC10,15,296225,296410,185,0.43783783783783786
CMK2,15,296226,296411,185,0.43783783783783786
ESC8,15,292138,292461,323,0.33746130030959753
TLG2,15,292139,292462,323,0.33746130030959753
YOL019W,15,288632,288755,123,0.36585365853658536
TAT2,15,285453,286084,631,0.3438985736925515
DIS3,15,285454,286085,631,0.34548335974643424
TSR4,15,281528,282228,700,0.35
IFM1,15,277338,278038,700,0.3271428571428571
LAG2,15,274365,274900,535,0.40186915887850466
MIM1,15,274366,274901,535,0.40186915887850466
MDM38,15,273753,273921,168,0.4583333333333333
YAP7,15,271587,271777,190,0.42105263157894735
YOL029C,15,271587,271777,190,0.42105263157894735
GAS5,15,267589,268138,549,0.3879781420765027
SIL1,15,267590,268139,549,0.3879781420765027
OPI10,15,265238,265341,103,0.3592233009708738
MSE1,15,263278,263416,138,0.3333333333333333
SMC5,15,259195,259895,700,0.36142857142857143
YOL036W,15,256159,256363,204,0.3235294117647059
PRE6,15,255084,255305,221,0.3936651583710407
RPP2A,15,253618,254268,650,0.4230769230769231
RPS15,15,253619,254269,650,0.4230769230769231
NOP12,15,252697,253057,360,0.30833333333333335
NGL1,15,249616,249758,142,0.36619718309859156
NTG2,15,249617,249759,142,0.36619718309859156
PEX15,15,246882,247085,203,0.35960591133004927
PSK2,15,244038,244738,700,0.36428571428571427
RRT8,15,241358,242058,700,0.37714285714285717
GSH2,15,238402,238576,174,0.40229885057471265
GAL11,15,234062,234762,700,0.43142857142857144
SPE2,15,233670,234370,700,0.39571428571428574
AIM39,15,229947,230162,215,0.31627906976744186
PSH1,15,227854,228554,700,0.3157142857142857
THI20,15,226455,227155,700,0.34714285714285714
GPM3,15,223048,223202,154,0.2857142857142857
YOL057W,15,220606,220739,133,0.3233082706766917
ARG1,15,218694,219138,444,0.4346846846846847
GPD2,15,216421,217121,700,0.4114285714285714
MAM3,15,216200,216900,700,0.44142857142857145
PRS5,15,212012,212201,189,0.36507936507936506
APM4,15,212013,212202,189,0.37037037037037035
CRT10,15,210338,210450,112,0.2767857142857143
MET22,15,207208,207342,134,0.35074626865671643
INP54,15,205912,205996,84,0.34523809523809523
RIB2,15,204521,204589,68,0.25
RTG1,15,202542,202632,90,0.35555555555555557
HST1,15,202541,202542,1,1.0
NUF2,15,198736,198904,168,0.32142857142857145
NBA1,15,198737,198905,168,0.3273809523809524
EMI5,15,196401,196502,101,0.297029702970297
THP1,15,193879,194579,700,0.44857142857142857
YOL073C,15,194833,195533,700,0.38
YOL075C,15,193622,193781,159,0.3522012578616352
MDM20,15,186750,187001,251,0.3745019920318725
BRX1,15,186751,187002,251,0.3705179282868526
AVO1,15,181470,181657,187,0.34759358288770054
REX4,15,181471,181658,187,0.35294117647058826
IRA2,15,170085,170785,700,0.4514285714285714
ATG19,15,167756,168456,700,0.32285714285714284
ATG34,15,165297,165619,322,0.3198757763975155
PHM7,15,161453,162153,700,0.46
ADH1,15,160632,161139,507,0.3826429980276134
YOL087C,15,158918,159125,207,0.3526570048309179
MPD2,15,154771,155152,381,0.28608923884514437
HAL9,15,153552,153747,195,0.3076923076923077
MSH2,15,146643,147343,700,0.3028571428571429
YOL092W,15,143801,144166,365,0.36712328767123287
TRM10,15,142598,142788,190,0.28421052631578947
RFC4,15,142599,142789,190,0.28421052631578947
HMI1,15,141380,141541,161,0.2795031055900621
COQ3,15,139074,139160,86,0.27906976744186046
WRS1,15,137850,137991,141,0.2765957446808511
YOL098C,15,135923,136428,505,0.3603960396039604
PKH2,15,128293,128993,700,0.38571428571428573
IZH4,15,127945,128645,700,0.38142857142857145
TPT1,15,126690,126889,199,0.3768844221105528
ITR2,15,123132,123832,700,0.32857142857142857
WSC3,15,116084,116784,700,0.3342857142857143
YOL107W,15,111889,112044,155,0.4
INO4,15,111890,112045,155,0.4
ZEO1,15,110039,110240,201,0.39303482587064675
SHR5,15,108944,109154,210,0.38095238095238093
MDY2,15,108945,109155,210,0.3761904761904762
MSB4,15,106385,106533,148,0.2972972972972973
SKM1,15,103941,104147,206,0.36893203883495146
YOL114C,15,103942,104148,206,0.36893203883495146
PAP2,15,101188,101408,220,0.2681818181818182
MSN1,15,99590,99677,87,0.3448275862068966
RRI2,15,96813,97513,700,0.36428571428571427
MCH4,15,96397,97097,700,0.37857142857142856
RPL18A,15,94422,94709,287,0.34494773519163763
RPS19A,15,92870,93307,437,0.36155606407322655
SMF1,15,91457,91947,490,0.3979591836734694
HRP1,15,86784,87463,679,0.3593519882179676
TRM11,15,86785,87464,679,0.3593519882179676
TRM13,15,83078,83778,700,0.41285714285714287
MDH2,15,82996,83696,700,0.4185714285714286
RPL25,15,79626,80326,700,0.41285714285714287
YGK3,15,79480,80180,700,0.4114285714285714
VPS68,15,77350,77539,189,0.3492063492063492
ALR1,15,73447,74147,700,0.36857142857142855
GAS4,15,71717,72417,700,0.37285714285714283
HRT1,15,70067,70293,226,0.3584070796460177
MED7,15,70068,70294,226,0.36283185840707965
PFK27,15,68982,69239,257,0.3735408560311284
BSC6,15,65413,65564,151,0.31125827814569534
RTC1,15,65414,65565,151,0.31125827814569534
CDC33,15,61102,61326,224,0.3080357142857143
ARG8,15,58005,58705,700,0.41
PPM2,15,56349,56413,64,0.359375
RRP40,15,55143,55544,401,0.42144638403990026
RIB4,15,55144,55545,401,0.42144638403990026
NOP8,15,52846,53049,203,0.2955665024630542
CTR9,15,52847,53050,203,0.2955665024630542
PSF3,15,48664,48850,186,0.3870967741935484
PEX11,15,48665,48851,186,0.3870967741935484
SPT20,15,47631,47784,153,0.37254901960784315
DCP1,15,44790,44914,124,0.33064516129032256
GRE2,15,42976,43676,700,0.33285714285714285
FRE7,15,40037,40737,700,0.3557142857142857
YOL153C,15,38614,39314,700,0.36
ZPS1,15,33910,34610,700,0.37
HPF1,15,31660,32360,700,0.4342857142857143
ENB1,15,21393,22093,700,0.36428571428571427
YOL159C,15,17814,18514,700,0.3028571428571429
BDS1,15,5228,5928,700,0.3842857142857143
RRP6,15,326232,326800,568,0.2623239436619718
ALG6,15,329108,329376,268,0.376865671641791
YSP3,15,331159,331395,236,0.3898305084745763
UTP23,15,333072,333547,475,0.3368421052631579
DNL4,15,337377,337608,231,0.2597402597402597
TSR3,15,338661,338840,179,0.2681564245810056
SGT2,15,339992,340692,700,0.3357142857142857
SLG1,15,342624,343324,700,0.38
TIR4,15,342962,343662,700,0.38142857142857145
TIR2,15,347217,347917,700,0.42428571428571427
AUS1,15,348989,349689,700,0.38857142857142857
YOR012W,15,356353,356506,153,0.28104575163398693
IRC11,15,356353,356506,153,0.28104575163398693
RTS1,15,357289,357419,130,0.4076923076923077
YOR015W,15,357419,357422,3,0.0
ERP4,15,361160,361369,209,0.3492822966507177
PET127,15,361159,361368,209,0.35406698564593303
ROD1,15,364017,364323,306,0.3366013071895425
YOR019W,15,367141,367841,700,0.3342857142857143
HSP10,15,370882,371582,700,0.3414285714285714
YOR021C,15,373479,373702,223,0.3452914798206278
YOR022C,15,375878,375959,81,0.30864197530864196
AHC1,15,377789,378200,411,0.4282238442822384
HST3,15,377788,378199,411,0.4282238442822384
BUB3,15,379711,379755,44,0.3409090909090909
STI1,15,380993,381017,24,0.4583333333333333
CIN5,15,384680,385380,700,0.42857142857142855
DFG16,15,386032,386732,700,0.33714285714285713
CRS5,15,388378,389078,700,0.3657142857142857
HMS1,15,391259,391959,700,0.43714285714285717
EXO1,15,394651,394729,78,0.34615384615384615
AKR2,15,397299,397370,71,0.36619718309859156
SHE4,15,400124,400333,209,0.36363636363636365
PEP12,15,400123,400332,209,0.36363636363636365
CYC2,15,401282,401516,234,0.3888888888888889
HIR2,15,405439,405606,167,0.32335329341317365
CKB2,15,405438,405605,167,0.32335329341317365
GLO4,15,406796,407033,237,0.35864978902953587
YOR041C,15,410009,410470,461,0.3405639913232104
CUE5,15,407923,408367,444,0.36936936936936937
WHI2,15,410008,410469,461,0.3405639913232104
IRC23,15,412485,412755,270,0.3333333333333333
TOM6,15,413695,413812,117,0.4017094017094017
DBP5,15,415937,416170,233,0.296137339055794
STD1,15,417819,418519,700,0.3628571428571429
RAT1,15,421691,422391,700,0.3357142857142857
RSB1,15,423917,424001,84,0.2857142857142857
YOR050C,15,425997,426136,139,0.35251798561151076
ETT1,15,426136,426519,383,0.3263707571801567
YOR052C,15,427337,427757,420,0.46190476190476193
VHS3,15,429998,430188,190,0.3526315789473684
NOB1,15,431695,432119,424,0.3561320754716981
SGT1,15,431694,432118,424,0.3561320754716981
ASE1,15,436481,437181,700,0.2714285714285714
YOR059C,15,441187,441190,3,0.6666666666666666
YOR060C,15,441190,441410,220,0.42272727272727273
CKA2,15,441189,441409,220,0.42272727272727273
YOR062C,15,443892,444592,700,0.38857142857142857
RPL3,15,443963,444663,700,0.3742857142857143
YNG1,15,446784,447193,409,0.38875305623471884
CYT1,15,446783,447192,409,0.39119804400978
MSA1,15,448895,449428,533,0.37335834896810505
ALG8,15,453503,453691,188,0.2872340425531915
VPS5,15,453502,453690,188,0.28191489361702127
GYP1,15,457965,458665,700,0.41
NRT1,15,461341,462041,700,0.43714285714285717
SGO1,15,464011,464711,700,0.34
CDC21,15,467636,468192,556,0.37949640287769787
UFE1,15,467635,468191,556,0.37949640287769787
SKI7,15,471633,471861,228,0.37280701754385964
RTS2,15,471632,471860,228,0.3684210526315789
BUD21,15,472002,472702,700,0.43
ATX2,15,474451,474573,122,0.26229508196721313
DIA2,15,474450,474572,122,0.27049180327868855
TGL5,15,479235,479458,223,0.27802690582959644
WHI5,15,479234,479457,223,0.27802690582959644
LPX1,15,479457,479671,214,0.42990654205607476
OST3,15,481799,481972,173,0.4277456647398844
TCB1,15,486972,487635,663,0.363499245852187
YVC1,15,486971,487634,663,0.363499245852187
VPS21,15,490890,491040,150,0.34
PTC5,15,492956,493371,415,0.363855421686747
TMA46,15,492955,493370,415,0.363855421686747
ECM3,15,494533,495045,512,0.4375
YOR093C,15,502493,502697,204,0.36764705882352944
ARF3,15,502492,502696,204,0.3627450980392157
RKI1,15,504398,505098,700,0.38
RPS7A,15,505065,505765,700,0.38285714285714284
YOR097C,15,507558,507812,254,0.3700787401574803
NUP1,15,511249,511764,515,0.37475728155339805
KTR1,15,511248,511763,515,0.3766990291262136
CRC1,15,514317,515017,700,0.40285714285714286
RAS1,15,514469,515169,700,0.39285714285714285
OST2,15,516875,517575,700,0.36142857142857143
PIN2,15,516925,517625,700,0.3557142857142857
YOR105W,15,516925,517625,700,0.3557142857142857
VAM3,15,518939,519039,100,0.33
RGS2,15,520361,521061,700,0.44142857142857145
LEU9,15,522595,522950,355,0.3436619718309859
INP53,15,524953,525176,223,0.3901345291479821
TFC7,15,528789,528857,68,0.3235294117647059
YOR111W,15,530315,530388,73,0.4246575342465753
CEX1,15,530731,531431,700,0.35
AZF1,15,533855,533968,113,0.45132743362831856
YOR114W,15,537048,537341,293,0.24573378839590443
TRS33,15,539516,539661,145,0.3586206896551724
RPO31,15,544359,544953,594,0.3484848484848485
RPT5,15,544358,544952,594,0.3501683501683502
RTC5,15,546473,546652,179,0.39664804469273746
RIO1,15,550289,550487,198,0.37373737373737376
GCY1,15,550288,550486,198,0.3686868686868687
PFY1,15,552915,553116,201,0.35323383084577115
LEO1,15,554643,554745,102,0.3431372549019608
UBP2,15,558749,558892,143,0.32167832167832167
CAT5,15,559780,559857,77,0.33766233766233766
IAH1,15,560708,561408,700,0.3657142857142857
RGA1,15,559856,560417,561,0.39037433155080214
ADE2,15,566226,566655,429,0.3006993006993007
AFI1,15,569636,569861,225,0.3377777777777778
ORT1,15,570830,571530,700,0.3871428571428571
YOR131C,15,572928,573095,167,0.3413173652694611
VPS17,15,572927,573094,167,0.3473053892215569
EFT1,15,574879,575051,172,0.32558139534883723
BAG7,15,577808,578408,600,0.41333333333333333
IDH2,15,579944,580145,201,0.2736318407960199
SIA1,15,584077,584243,166,0.3614457831325301
RUP1,15,586394,586645,251,0.46215139442231074
SFL1,15,586393,586644,251,0.46215139442231074
ARP8,15,592610,592864,254,0.40551181102362205
LSC1,15,592609,592863,254,0.40551181102362205
THI80,15,602418,602559,141,0.3120567375886525
ELG1,15,605093,605258,165,0.37575757575757573
PNO1,15,606192,606441,249,0.30522088353413657
YOR146W,15,605257,605792,535,0.3813084112149533
MDM32,15,606440,606569,129,0.34108527131782945
SPP2,15,609229,609499,270,0.36666666666666664
SMP3,15,611432,611972,540,0.34444444444444444
MRPL23,15,611431,611971,540,0.34444444444444444
RPB2,15,616932,617352,420,0.35
YOR152C,15,618477,619177,700,0.37285714285714283
PDR5,15,618948,619648,700,0.4442857142857143
SLP1,15,624488,624681,193,0.3316062176165803
ISN1,15,627994,628111,117,0.3504273504273504
NFI1,15,630707,630914,207,0.25120772946859904
PUP1,15,631816,632139,323,0.37770897832817335
PET123,15,631815,632138,323,0.37770897832817335
SME1,15,633624,633771,147,0.2789115646258503
MTR10,15,633623,633770,147,0.2789115646258503
PNS1,15,638697,638824,127,0.3464566929133858
YRR1,15,642179,642704,525,0.3942857142857143
DDP1,15,642178,642703,525,0.3923809523809524
GET4,15,644369,644533,164,0.31097560975609756
SEY1,15,644368,644532,164,0.31097560975609756
SWT1,15,648557,648674,117,0.37606837606837606
RPS28A,15,649019,649275,256,0.3203125
GLN4,15,649018,649274,256,0.3203125
LCB4,15,653952,654170,218,0.41284403669724773
YRM1,15,653951,654169,218,0.41284403669724773
DCS2,15,656741,657215,474,0.4008438818565401
MED4,15,658465,658644,179,0.39106145251396646
ALE1,15,661752,662334,582,0.38316151202749144
HEM15,15,661751,662333,582,0.38316151202749144
GAC1,15,670589,671289,700,0.43
SYC1,15,672440,673140,700,0.33714285714285713
DCI1,15,675662,675874,212,0.28773584905660377
LAS17,15,675661,675873,212,0.28773584905660377
RPS30B,15,678821,679247,426,0.4084507042253521
SER1,15,678820,679246,426,0.4061032863849765
GSP2,15,682164,682864,700,0.42142857142857143
YOR186W,15,681377,681490,113,0.2831858407079646
TUF1,15,683657,683960,303,0.38283828382838286
MSB1,15,685464,685670,206,0.3592233009708738
IES4,15,689309,689602,293,0.32081911262798635
SPR1,15,690196,690331,135,0.35555555555555557
ULS1,15,692292,692384,92,0.32608695652173914
THI72,15,701127,701827,700,0.4357142857142857
PEX27,15,709689,710389,700,0.3171428571428571
TOA1,15,712612,712796,184,0.3423913043478261
SLK19,15,712611,712795,184,0.3423913043478261
LIP5,15,716861,717070,209,0.36363636363636365
MCA1,15,716860,717069,209,0.3588516746411483
BFR1,15,720244,720396,152,0.375
MRM1,15,721749,721936,187,0.31016042780748665
HIS3,15,721748,721935,187,0.3048128342245989
DED1,15,722693,722891,198,0.3686868686868687
GEP3,15,727242,727483,241,0.2946058091286307
NOC2,15,727241,727482,241,0.2946058091286307
RET1,15,733496,733713,217,0.31336405529953915
PTP2,15,733495,733712,217,0.31797235023041476
NPT1,15,737874,738270,396,0.3333333333333333
RPB10,15,737873,738269,396,0.33585858585858586
MGM1,15,741776,742476,700,0.37142857142857144
STE4,15,741986,742686,700,0.37857142857142856
SAS5,15,745389,746089,700,0.38571428571428573
AIM41,15,747312,747422,110,0.37272727272727274
RUD3,15,749039,749214,175,0.35428571428571426
RFC1,15,749038,749213,175,0.3485714285714286
STE13,15,755074,755304,230,0.3521739130434783
RCN2,15,755073,755303,230,0.3565217391304348
MCT1,15,757610,758302,692,0.37716763005780346
ODC2,15,757609,758301,692,0.37716763005780346
YOR223W,15,759312,759739,427,0.34192037470725994
RPB8,15,761301,761457,156,0.30128205128205127
ISU2,15,762105,762595,490,0.42244897959183675
HER1,15,762104,762594,490,0.42244897959183675
YOR228C,15,767997,768321,324,0.37962962962962965
WTM2,15,767996,768320,324,0.37962962962962965
WTM1,15,770048,770748,700,0.38285714285714284
MKK1,15,772300,772451,151,0.4105960264900662
MGE1,15,774344,774465,121,0.4049586776859504
KIN4,15,775393,775667,274,0.32116788321167883
RPL33B,15,779423,780123,700,0.41
DFR1,15,780191,780891,700,0.37285714285714283
HES1,15,781606,781800,194,0.4381443298969072
YOR238W,15,783280,783669,389,0.2519280205655527
ABP140,15,784659,784813,154,0.37662337662337664
MET7,15,786950,787072,122,0.27049180327868855
SSP2,15,789901,789983,82,0.2926829268292683
PUS7,15,792258,792483,225,0.3377777777777778
ESA1,15,792257,792482,225,0.3377777777777778
DGA1,15,795546,795718,172,0.38953488372093026
YOR246C,15,796856,797443,587,0.3969335604770017
SRL1,15,796855,797442,587,0.3969335604770017
YOR248W,15,796855,797442,587,0.3969335604770017
APC5,15,800749,800930,181,0.3149171270718232
CLP1,15,802345,802455,110,0.35454545454545455
TUM1,15,803489,803635,146,0.3424657534246575
TMA16,15,803488,803634,146,0.3493150684931507
NAT5,15,804279,804348,69,0.2608695652173913
SEC63,15,807047,807747,700,0.39
TRE2,15,810838,810974,136,0.3235294117647059
CDC31,15,810837,810973,136,0.3235294117647059
HNT3,15,811547,811657,110,0.4
RPT4,15,813733,813940,207,0.3961352657004831
GCD1,15,813732,813939,207,0.40096618357487923
RPN8,15,817029,817230,201,0.3582089552238806
YOR262W,15,817028,817229,201,0.35323383084577115
DSE3,15,818435,818812,377,0.4005305039787798
RBL2,15,820340,820419,79,0.379746835443038
PNT1,15,820808,820946,138,0.3333333333333333
HRK1,15,825042,825742,700,0.38571428571428573
PAC1,15,825608,826308,700,0.4328571428571429
VPH1,15,830745,830961,216,0.3425925925925926
FSF1,15,832097,832766,669,0.4155455904334828
YTM1,15,832096,832765,669,0.4155455904334828
TPO4,15,836515,837215,700,0.44285714285714284
MOD5,15,836963,837663,700,0.39
RIM20,15,841077,841291,214,0.3598130841121495
CAF20,15,841076,841290,214,0.3598130841121495
HEM4,15,842095,842795,700,0.36142857142857143
RFM1,15,844741,844927,186,0.3333333333333333
FSH3,15,845812,846173,361,0.3684210526315789
PLP2,15,847157,847349,192,0.3229166666666667
YOR283W,15,847156,847348,192,0.328125
HUA2,15,848287,848428,141,0.2978723404255319
RDL1,15,849489,849626,137,0.35766423357664234
RDL2,15,850121,850262,141,0.3617021276595745
RRP36,15,851861,852043,182,0.34065934065934067
MPD1,15,853118,853341,223,0.3542600896860987
YOR289W,15,853117,853340,223,0.34977578475336324
SNF2,15,860392,860884,492,0.34552845528455284
YPK9,15,860391,860883,492,0.3475609756097561
YOR292C,15,866626,867071,445,0.44269662921348313
RPS10A,15,866625,867070,445,0.44269662921348313
RRS1,15,867992,868297,305,0.3540983606557377
UAF30,15,869099,869130,31,0.25806451612903225
YOR296W,15,870119,870123,4,0.25
TIM18,15,875347,876047,700,0.35428571428571426
BUD7,15,878326,878347,21,0.14285714285714285
YOR300W,15,877738,878326,588,0.4387755102040816
RAX1,15,880902,880946,44,0.38636363636363635
YOR302W,15,882581,882666,85,0.25882352941176473
CPA1,15,882581,882666,85,0.25882352941176473
ISW2,15,884207,884338,131,0.366412213740458
RRG7,15,888755,888958,203,0.3448275862068966
MCH5,15,891596,892296,700,0.38857142857142857
SLY41,15,894264,894440,176,0.2840909090909091
SNU66,15,896411,896568,157,0.31210191082802546
YOR309C,15,898393,898849,456,0.33771929824561403
NOP58,15,898393,898849,456,0.33771929824561403
DGK1,15,899975,900164,189,0.37566137566137564
RPL20B,15,901221,901647,426,0.4413145539906103
SPS4,15,903370,904070,700,0.3628571428571429
SFG1,15,903982,904682,700,0.36428571428571427
COT1,15,907706,908170,464,0.43103448275862066
FAA1,15,908613,909313,700,0.4228571428571429
YOR318C,15,912539,912798,259,0.3667953667953668
HSH49,15,912538,912797,259,0.36293436293436293
GNT1,15,915211,915911,700,0.37
PMT3,15,915285,915985,700,0.36714285714285716
LDB19,15,921300,921447,147,0.3673469387755102
PRO2,15,922924,923097,173,0.37572254335260113
FRT1,15,925184,925526,342,0.391812865497076
YOR325W,15,923227,923927,700,0.3485714285714286
MYO2,15,925183,925525,342,0.39473684210526316
SNC2,15,931169,931869,700,0.40714285714285714
PDR10,15,932913,933613,700,0.39285714285714285
SCD5,15,939450,939594,144,0.2638888888888889
MIP1,15,943434,943625,191,0.4397905759162304
VMA4,15,943433,943624,191,0.44502617801047123
YOR333C,15,945041,945741,700,0.3628571428571429
MRS2,15,944497,944564,67,0.44776119402985076
ALA1,15,949216,949748,532,0.3458646616541353
KRE5,15,949215,949747,532,0.34774436090225563
TEA1,15,954025,954284,259,0.3667953667953668
YOR338W,15,956130,956830,700,0.40714285714285714
UBC11,15,959547,960211,664,0.37801204819277107
RPA43,15,960211,960870,659,0.3201820940819423
RPA190,15,960210,960869,659,0.3186646433990895
YOR342C,15,967734,968434,700,0.43
YOR343C,15,968649,969349,700,0.3742857142857143
TYE7,15,978201,978901,700,0.3942857142857143
REV1,15,980956,981656,700,0.31285714285714283
PYK2,15,986553,986682,129,0.32558139534883723
PUT4,15,988874,989574,700,0.48
CIN1,15,988993,989693,700,0.48
MNE1,15,994878,995578,700,0.35
YOR352W,15,996437,997137,700,0.39571428571428574
SOG2,15,1000874,1001028,154,0.2597402597402597
MSC6,15,1003250,1003950,700,0.3514285714285714
GDS1,15,1003931,1004631,700,0.3242857142857143
YOR356W,15,1006892,1007193,301,0.33222591362126247
SNX3,15,1009721,1010116,395,0.4177215189873418
HAP5,15,1009720,1010115,395,0.4177215189873418
VTS1,15,1010368,1011068,700,0.43857142857142856
PDE2,15,1015053,1015225,172,0.3081395348837209
PRT1,15,1017577,1017744,167,0.30538922155688625
PRE10,15,1018785,1019485,700,0.39
PIP2,15,1023468,1023479,11,0.2727272727272727
YOR366W,15,1023467,1023478,11,0.2727272727272727
SCP1,15,1025641,1025981,340,0.34705882352941175
RAD17,15,1026701,1026811,110,0.36363636363636365
RPS12,15,1028693,1029021,328,0.34146341463414637
MRS6,15,1031327,1031405,78,0.23076923076923078
GPB1,15,1034301,1034474,173,0.3699421965317919
NDD1,15,1036519,1036773,254,0.4015748031496063
NUD1,15,1036518,1036772,254,0.40551181102362205
ALD4,15,1039404,1039791,387,0.4289405684754522
GDH1,15,1043110,1043810,700,0.42428571428571427
ATF1,15,1045797,1046174,377,0.4005305039787798
YOR378W,15,1048704,1049404,700,0.43142857142857144
RDR1,15,1050381,1051081,700,0.4514285714285714
FRE3,15,1054311,1055011,700,0.3585714285714286
FIT2,15,1059218,1059513,295,0.3898305084745763
FIT3,15,1061102,1061445,343,0.36443148688046645
FRE5,15,1061101,1061444,343,0.36151603498542273
YOR385W,15,1064604,1065034,430,0.37209302325581395
PHR1,15,1066197,1066820,623,0.3290529695024077
YOR389W,15,1073473,1074173,700,0.33714285714285713
HAT1,16,554346,554575,229,0.32751091703056767
SNF8,16,554347,554576,229,0.32751091703056767
ULA1,16,551682,552003,321,0.40809968847352024
LSP1,16,551683,552004,321,0.40809968847352024
AEP3,16,548211,548459,248,0.3709677419354839
NCR1,16,543885,544582,697,0.36872309899569583
TFC8,16,543886,544583,697,0.36872309899569583
CHL1,16,538958,539148,190,0.3473684210526316
TAE2,16,538959,539149,190,0.3473684210526316
RET3,16,534750,534952,202,0.3712871287128713
TAF3,16,534751,534953,202,0.3712871287128713
RRP12,16,529376,529613,237,0.350210970464135
MRPS16,16,529377,529614,237,0.350210970464135
CIP1,16,526938,527517,579,0.4421416234887737
HST2,16,526939,527518,579,0.4438687392055268
SWI1,16,520369,520629,260,0.4230769230769231
IRC15,16,520370,520630,260,0.4230769230769231
CTF19,16,517152,517637,485,0.43917525773195876
VTC3,16,517153,517638,485,0.43917525773195876
ULP1,16,514308,514431,123,0.36585365853658536
RAD1,16,506442,506610,168,0.4166666666666667
MET12,16,506443,506611,168,0.4226190476190476
RMI1,16,503269,503439,170,0.29411764705882354
YPL025C,16,503270,503440,170,0.28823529411764703
SKS1,16,502249,502260,11,0.45454545454545453
SMA1,16,499387,499593,206,0.4174757281553398
ERG10,16,497785,498033,248,0.49193548387096775
SUV3,16,495347,495486,139,0.33093525179856115
TRM44,16,493072,493486,414,0.3719806763285024
PHO85,16,493073,493487,414,0.3719806763285024
SVL3,16,491566,491936,370,0.4
YPL034W,16,486220,486377,157,0.31210191082802546
PMA2,16,481931,482277,346,0.3930635838150289
EGD1,16,481932,482278,346,0.3959537572254335
MET31,16,480312,480506,194,0.30412371134020616
YPL039W,16,479049,479199,150,0.3333333333333333
ISM1,16,479050,479200,150,0.3333333333333333
YPL041C,16,475767,476018,251,0.398406374501992
SSN3,16,474951,474957,6,0.16666666666666666
NOP4,16,469181,469881,700,0.34285714285714286
VPS16,16,466990,467144,154,0.3246753246753247
ELC1,16,466991,467145,154,0.3181818181818182
SGF11,16,465767,465883,116,0.27586206896551724
CAM1,16,463892,464364,472,0.4322033898305085
DIG1,16,463893,464365,472,0.4322033898305085
MNN9,16,462160,462293,133,0.3233082706766917
ARL3,16,459866,459927,61,0.29508196721311475
OAZ1,16,458529,458741,212,0.3113207547169811
KTR6,16,458530,458742,212,0.3113207547169811
LEE1,16,454999,455613,614,0.39087947882736157
LGE1,16,455000,455614,614,0.38925081433224756
LCL1,16,454990,455000,10,0.4
SUR1,16,453237,453915,678,0.4424778761061947
PDR12,16,450802,451463,661,0.4583963691376702
GRX5,16,443824,444524,700,0.3385714285714286
MFM1,16,434211,434283,72,0.3194444444444444
ALD6,16,431843,432543,700,0.46285714285714286
TIM50,16,429624,429814,190,0.29473684210526313
CWC27,16,429625,429815,190,0.29473684210526313
VPS28,16,427777,427909,132,0.3484848484848485
YPL066W,16,425903,426061,158,0.36075949367088606
YPL067C,16,425904,426062,158,0.3670886075949367
YPL068C,16,425136,425162,26,0.38461538461538464
BTS1,16,423932,424150,218,0.3577981651376147
MUK1,16,420563,420740,177,0.3672316384180791
YPL071C,16,420564,420741,177,0.3672316384180791
UBP16,16,418158,418328,170,0.25882352941176473
YTA6,16,415582,415742,160,0.39375
GCR1,16,412051,412175,124,0.43548387096774194
GPI2,16,410115,410296,181,0.36464088397790057
YPL077C,16,410116,410297,181,0.35911602209944754
ATP4,16,408799,409016,217,0.43317972350230416
RPL21B,16,406215,406609,394,0.4213197969543147
RPS9A,16,404425,404917,492,0.3556910569105691
MOT1,16,404426,404918,492,0.3556910569105691
SEN54,16,398183,398338,155,0.3096774193548387
BRO1,16,393621,393989,368,0.3423913043478261
SEC16,16,386485,386885,400,0.3225
ELP3,16,386486,386886,400,0.325
YDC1,16,383079,383367,288,0.3784722222222222
YPL088W,16,381415,381925,510,0.36666666666666664
RLM1,16,381416,381926,510,0.36666666666666664
RPS6A,16,378426,378992,566,0.4275618374558304
GLR1,16,375267,375481,214,0.34579439252336447
SSU1,16,373157,373660,503,0.37773359840954274
NOG1,16,370680,370924,244,0.3770491803278688
SEC62,16,370681,370925,244,0.3729508196721312
EEB1,16,369474,369774,300,0.39666666666666667
PNG1,16,366781,366904,123,0.36585365853658536
MSY1,16,364783,364929,146,0.3698630136986301
MGR2,16,364784,364930,146,0.3767123287671233
AIM43,16,364088,364216,128,0.359375
ATG21,16,361702,361818,116,0.39655172413793105
ELP4,16,359469,360169,700,0.3442857142857143
FMP30,16,359425,360125,700,0.34
MSD1,16,355434,355658,224,0.36160714285714285
SYH1,16,355435,355659,224,0.36607142857142855
SSE1,16,352316,352703,387,0.3178294573643411
YPL107W,16,348364,349064,700,0.39285714285714285
YPL109C,16,347466,348166,700,0.34714285714285714
GDE1,16,344926,345185,259,0.3088803088803089
CAR1,16,339197,339897,700,0.4328571428571429
PEX25,16,338683,339383,700,0.38571428571428573
YPL113C,16,337175,337370,195,0.37435897435897436
YPL114W,16,335858,335891,33,0.3333333333333333
BEM3,16,335718,335859,141,0.3617021276595745
HOS3,16,328836,329431,595,0.29411764705882354
IDI1,16,328837,329432,595,0.29411764705882354
MRP51,16,326329,326541,212,0.3113207547169811
DBP1,16,326330,326542,212,0.3113207547169811
VPS30,16,321354,322054,700,0.37142857142857144
TFB2,16,320793,321493,700,0.3442857142857143
RNY1,16,319005,319150,145,0.3310344827586207
SPC29,16,316545,316723,178,0.3089887640449438
KAP120,16,313001,313241,240,0.3125
NAN1,16,309626,310169,543,0.3996316758747698
HHO1,16,309627,310170,543,0.4014732965009208
TBF1,16,308290,308688,398,0.3316582914572864
TAF14,16,304540,305240,700,0.34714285714285714
RPL5,16,302695,303101,406,0.34236453201970446
COX11,16,301348,301579,231,0.3593073593073593
RDS2,16,301349,301580,231,0.354978354978355
ODC1,16,299532,299742,210,0.4095238095238095
ISU1,16,296763,297463,700,0.41285714285714287
GIP3,16,296684,297384,700,0.40714285714285714
SPP1,16,292455,292651,196,0.34183673469387754
UME1,16,291107,291239,132,0.3712121212121212
MKK2,16,289253,289578,325,0.2953846153846154
FRK1,16,286318,287018,700,0.35285714285714287
RPL33A,16,281392,282092,700,0.3742857142857143
POC4,16,279954,280466,512,0.40625
KES1,16,279955,280467,512,0.40625
NOP53,16,277565,277909,344,0.3488372093023256
PXA1,16,272940,273169,229,0.34497816593886466
PPT2,16,272941,273170,229,0.3406113537117904
ATG5,16,270945,271235,290,0.32068965517241377
YPL150W,16,267563,267785,222,0.34684684684684686
PRP46,16,267564,267786,222,0.34234234234234234
RRD2,16,264331,264965,634,0.38170347003154576
RAD53,16,264332,264966,634,0.38170347003154576
PEP4,16,261198,261547,349,0.3638968481375358
KIP2,16,259377,259588,211,0.3981042654028436
PRM4,16,256827,257527,700,0.42142857142857143
TGS1,16,254379,254705,326,0.3619631901840491
AIM44,16,254380,254706,326,0.3619631901840491
PET20,16,251761,251979,218,0.3532110091743119
CDC60,16,246277,246926,649,0.3728813559322034
BEM4,16,246278,246927,649,0.3713405238828968
YPL162C,16,244085,244286,201,0.31343283582089554
SVS1,16,242723,243423,700,0.36428571428571427
ATG29,16,237149,237296,147,0.3469387755102041
REV3,16,237150,237297,147,0.3469387755102041
YPL168W,16,230873,231071,198,0.32323232323232326
MEX67,16,230874,231072,198,0.3181818181818182
DAP1,16,227556,228256,700,0.4185714285714286
OYE3,16,227378,228078,700,0.4185714285714286
COX10,16,225850,226055,205,0.35121951219512193
MRPL40,16,222907,223096,189,0.3333333333333333
NIP100,16,222908,223097,189,0.3333333333333333
SPT14,16,218389,218573,184,0.30978260869565216
TRE1,16,218390,218574,184,0.30978260869565216
CUP9,16,214044,214744,700,0.41
CBC2,16,211409,212109,700,0.30142857142857143
PPQ1,16,207848,207994,146,0.3424657534246575
TCO89,16,205048,205201,153,0.43790849673202614
CTI6,16,202595,203295,700,0.36
RTT10,16,202570,203270,700,0.3657142857142857
MRN1,16,198460,199011,551,0.3938294010889292
UIP4,16,195678,195834,156,0.4166666666666667
MF(ALPHA)1,16,192981,193681,700,0.3157142857142857
POS5,16,191104,191389,285,0.30526315789473685
GUP2,16,188603,189031,428,0.36682242990654207
NAB3,16,187819,188071,252,0.3531746031746032
YPL191C,16,184732,184909,177,0.4067796610169492
RSA1,16,181337,181363,26,0.19230769230769232
DDC1,16,179122,179251,129,0.3643410852713178
APL5,16,175921,176209,288,0.3333333333333333
OXR1,16,174794,175002,208,0.38461538461538464
RPL7B,16,173025,173124,99,0.3434343434343434
YPL199C,16,172767,173026,259,0.3783783783783784
CSM4,16,171189,171233,44,0.29545454545454547
YIG1,16,171190,171234,44,0.29545454545454547
AFT2,16,169431,169694,263,0.3612167300380228
TPK2,16,165893,166093,200,0.39
HRR25,16,163621,164081,460,0.3673913043478261
PGC1,16,163622,164082,460,0.3652173913043478
TYW1,16,159664,159849,185,0.4
RKM1,16,157674,157827,153,0.3660130718954248
IPL1,16,157675,157828,153,0.3660130718954248
SRP72,16,156237,156387,150,0.30666666666666664
NIP7,16,153178,153465,287,0.2926829268292683
PUS1,16,153179,153466,287,0.2926829268292683
LEA1,16,150291,150577,286,0.32867132867132864
THI6,16,150292,150578,286,0.32867132867132864
CBP3,16,147161,147386,225,0.36444444444444446
YPL216W,16,143221,143409,188,0.324468085106383
BMS1,16,143222,143410,188,0.324468085106383
SAR1,16,138323,138635,312,0.38782051282051283
PCL8,16,136530,136707,177,0.4350282485875706
RPL1A,16,135599,135777,178,0.38764044943820225
FLC1,16,132317,132811,494,0.44534412955465585
FMP40,16,129349,130049,700,0.42142857142857143
GRE1,16,129230,129930,700,0.3985714285714286
MMT2,16,128104,128590,486,0.3662551440329218
YPL225W,16,125608,125983,375,0.336
NEW1,16,121299,121737,438,0.3059360730593607
ALG5,16,121300,121738,438,0.3059360730593607
CET1,16,117953,118238,285,0.34035087719298246
YPL229W,16,116568,117036,468,0.36538461538461536
USV1,16,114368,115068,700,0.4942857142857143
FAS2,16,108225,108584,359,0.38997214484679665
SSO1,16,106411,107111,700,0.41285714285714287
NSL1,16,105494,106118,624,0.3605769230769231
VMA11,16,105495,106119,624,0.3605769230769231
RVB2,16,102772,103154,382,0.3481675392670157
YPL236C,16,102773,103155,382,0.3481675392670157
SUI3,16,100256,100452,196,0.3622448979591837
YAR1,16,98705,99405,700,0.3628571428571429
HSP82,16,98674,99374,700,0.36857142857142855
CIN2,16,96266,96397,131,0.31297709923664124
IQG1,16,95173,95292,119,0.2857142857142857
SRP68,16,88056,88430,374,0.35561497326203206
HUT1,16,88057,88431,374,0.35561497326203206
YPL245W,16,85336,85555,219,0.3926940639269406
RBD2,16,85337,85556,219,0.3926940639269406
YPL247C,16,84317,84410,93,0.40860215053763443
GAL4,16,82396,82549,153,0.3660130718954248
GYP5,16,79393,79528,135,0.3037037037037037
ICY2,16,74786,75486,700,0.47
YAH1,16,73925,74131,206,0.2669902912621359
VIK1,16,73055,73234,179,0.30726256983240224
HFI1,16,69114,69248,134,0.31343283582089554
BBP1,16,66972,67672,700,0.3985714285714286
CLN2,16,66789,67489,700,0.4085714285714286
YPL257W,16,62534,63234,700,0.32142857142857145
THI21,16,55762,56462,700,0.36142857142857143
APM1,16,52689,53389,700,0.3342857142857143
YPL260W,16,48845,49206,361,0.3684210526315789
FUM1,16,46629,47329,700,0.4114285714285714
KEL3,16,46525,47225,700,0.4057142857142857
YPL264C,16,44366,44509,143,0.32167832167832167
DIP5,16,40229,40929,700,0.43142857142857144
DIM1,16,38861,39064,203,0.31527093596059114
ACM1,16,37901,38153,252,0.35714285714285715
PLC1,16,35087,35204,117,0.3333333333333333
KAR9,16,32901,33003,102,0.3431372549019608
MDL2,16,30387,30458,71,0.30985915492957744
ATP15,16,29820,30051,231,0.33766233766233766
YPL272C,16,29821,30052,231,0.3333333333333333
SAM4,16,24744,25013,269,0.3903345724907063
SAM3,16,22185,22885,700,0.39714285714285713
CIT3,16,555782,556281,499,0.2665330661322645
PDH1,16,557958,558373,415,0.3349397590361446
YPR003C,16,563820,563951,131,0.3511450381679389
AIM45,16,565056,565453,397,0.3501259445843829
HAL1,16,566882,567582,700,0.3914285714285714
ICL2,16,569074,569774,700,0.41714285714285715
REC8,16,570642,571342,700,0.3414285714285714
HAA1,16,572000,572700,700,0.3742857142857143
SUT2,16,575757,576457,700,0.37285714285714283
RPA135,16,581238,581938,700,0.3514285714285714
YPR011C,16,584139,584376,237,0.3670886075949367
YPR013C,16,586070,586770,700,0.4057142857142857
YPR015C,16,591114,591814,700,0.3942857142857143
TIF6,16,593164,593231,67,0.2835820895522388
DSS4,16,593927,594386,459,0.39869281045751637
RLF2,16,593926,594385,459,0.39651416122004357
MCM4,16,596430,596673,243,0.345679012345679
ATP20,16,599658,599820,162,0.37037037037037035
AGC1,16,603586,603747,161,0.37888198757763975
YPR022C,16,607349,608049,700,0.33714285714285713
EAF3,16,610071,610311,240,0.44583333333333336
YME1,16,610070,610310,240,0.44583333333333336
CCL1,16,614578,614798,220,0.36818181818181817
ATH1,16,614577,614797,220,0.37272727272727274
YOP1,16,622779,623479,700,0.3757142857142857
APL4,16,627011,627711,700,0.4014285714285714
CSR2,16,628537,629237,700,0.41
NTO1,16,631341,631485,144,0.3055555555555556
SRO7,16,633835,634072,237,0.270042194092827
HTS1,16,639020,639460,440,0.34545454545454546
ARP7,16,639019,639459,440,0.34545454545454546
GLN1,16,641390,642090,700,0.40285714285714286
VMA13,16,643470,643788,318,0.3113207547169811
ERV2,16,647085,647285,200,0.4
TIP41,16,647084,647284,200,0.405
TIF5,16,648446,648596,150,0.34
PUF2,16,653802,654135,333,0.35735735735735735
RPL43A,16,653801,654134,333,0.36036036036036034
THP3,16,656610,656789,179,0.37988826815642457
MCM16,16,656609,656788,179,0.37988826815642457
MSF1,16,657419,657468,49,0.2857142857142857
TAH18,16,659041,659157,116,0.3103448275862069
ATG11,16,664721,664933,212,0.3490566037735849
MAK3,16,664720,664932,212,0.35377358490566035
NHP6A,16,665999,666699,700,0.4442857142857143
YPR053C,16,667319,667495,176,0.3693181818181818
SMK1,16,665572,665583,11,0.45454545454545453
SEC8,16,667494,667628,134,0.29850746268656714
TFB4,16,670935,671102,167,0.2874251497005988
BRR1,16,672341,672465,124,0.3629032258064516
YMC1,16,673551,673729,178,0.4101123595505618
ARO7,16,675690,675851,161,0.2484472049689441
JID1,16,676915,677136,221,0.38009049773755654
FCY1,16,676914,677135,221,0.38009049773755654
YPR063C,16,678371,679071,700,0.4614285714285714
YPR064W,16,676914,677135,221,0.38009049773755654
ROX1,16,679443,679636,193,0.29533678756476683
UBA3,16,680982,681205,223,0.21524663677130046
ISA2,16,681473,682173,700,0.4228571428571429
HOS1,16,684370,684492,122,0.1885245901639344
SPE3,16,685479,685857,378,0.30423280423280424
MED1,16,685478,685856,378,0.30423280423280424
YPR071W,16,687943,688144,201,0.3582089552238806
NOT5,16,689305,690005,700,0.34
LTP1,16,692480,692661,181,0.3370165745856354
TKL1,16,694903,695603,700,0.39714285714285713
OPY2,16,696874,697574,700,0.39285714285714285
MRL1,16,698079,698779,700,0.32142857142857145
TEF1,16,700096,700562,466,0.37553648068669526
GRS2,16,703973,704146,173,0.32947976878612717
DIB1,16,704672,704830,158,0.3987341772151899
MDM36,16,704671,704829,158,0.3987341772151899
YPR084W,16,706713,706856,143,0.34965034965034963
ASA1,16,709915,710057,142,0.28169014084507044
SUA7,16,709914,710056,142,0.2746478873239437
SRP54,16,713051,713236,185,0.3621621621621622
YPR089W,16,713050,713235,185,0.3621621621621622
YPR091C,16,718496,719196,700,0.3514285714285714
ASR1,16,720488,720607,119,0.2857142857142857
RDS3,16,720487,720606,119,0.29411764705882354
YPR097W,16,724457,725157,700,0.38857142857142857
YPR098C,16,729567,729755,188,0.3404255319148936
YPR099C,16,730204,730312,108,0.25
MRPL51,16,729566,729754,188,0.3351063829787234
SNT309,16,730311,730466,155,0.3419354838709677
RPL11A,16,731779,732278,499,0.3847695390781563
PRE2,16,731778,732277,499,0.3867735470941884
FHL1,16,736718,736911,193,0.3160621761658031
COG4,16,739642,740049,407,0.3464373464373464
ISR1,16,739641,740048,407,0.3464373464373464
YTH1,16,742148,742374,226,0.3407079646017699
RPN7,16,742147,742373,226,0.3407079646017699
YPR109W,16,743935,744509,574,0.343205574912892
RPC40,16,746849,747266,417,0.3069544364508393
DBF20,16,746848,747265,417,0.3069544364508393
MRD1,16,751971,752232,261,0.3524904214559387
PIS1,16,751970,752231,261,0.3524904214559387
YPR114W,16,753099,753222,123,0.37398373983739835
RGC1,16,754368,754684,316,0.4272151898734177
RRG8,16,758300,758637,337,0.37388724035608306
MRI1,16,767022,767722,700,0.33285714285714285
CLB2,16,770603,771303,700,0.35428571428571426
CLB5,16,775296,775996,700,0.38571428571428573
THI22,16,777729,778429,700,0.37857142857142856
AXL1,16,783682,784382,700,0.38142857142857145
YPR123C,16,787680,787865,185,0.3837837837837838
CTR1,16,785798,786035,237,0.3628691983122363
YLH47,16,787679,787864,185,0.3837837837837838
YPR127W,16,789507,790029,522,0.39080459770114945
ANT1,16,792257,792665,408,0.375
SCD6,16,792256,792664,408,0.375
NAT3,16,794525,794942,417,0.3908872901678657
RPS23B,16,794524,794941,417,0.3908872901678657
SPN1,16,797285,797524,239,0.37656903765690375
MSS18,16,797876,798041,165,0.3151515151515151
CTF4,16,798989,799176,187,0.33689839572192515
RRP9,16,802065,802281,216,0.3425925925925926
MEP3,16,812683,813067,384,0.4322916666666667
VPS66,16,814119,814301,182,0.3626373626373626
TAZ1,16,814118,814300,182,0.3626373626373626
KAR3,16,818094,818288,194,0.30927835051546393
RRP15,16,818093,818287,194,0.30927835051546393
NOC4,16,821446,822146,700,0.3442857142857143
ASN1,16,821877,822577,700,0.41285714285714287
YPR146C,16,826627,826714,87,0.42528735632183906
YPR147C,16,826615,826627,12,0.5
YPR148C,16,828199,828899,700,0.38
NCE102,16,829053,829753,700,0.4142857142857143
SUE1,16,831667,831737,70,0.32857142857142857
URN1,16,833480,833658,178,0.29775280898876405
YPR153W,16,833479,833657,178,0.29775280898876405
PIN3,16,833832,834532,700,0.4042857142857143
NCA2,16,837479,837735,256,0.3046875
TPO3,16,840071,840771,700,0.4185714285714286
YPR157W,16,840514,841214,700,0.37142857142857144
CUR1,16,842784,843194,410,0.32439024390243903
KRE6,16,856689,857389,700,0.36142857142857143
GPH1,16,860482,861182,700,0.42142857142857143
SGV1,16,866494,866669,175,0.3485714285714286
ORC4,16,868323,868476,153,0.22875816993464052
TIF3,16,870041,870663,622,0.3617363344051447
MMS1,16,870040,870662,622,0.36012861736334406
RHO1,16,875142,875162,20,0.2
MRP2,16,876663,876791,128,0.3828125
MET16,16,877762,878065,303,0.34983498349834985
NUT2,16,877761,878064,303,0.35313531353135313
JIP5,16,878064,878655,591,0.38578680203045684
YPR170C,16,883579,883791,212,0.28773584905660377
BSP1,16,883790,883791,1,0.0
YPR172W,16,885650,885765,115,0.3739130434782609
VPS4,16,887869,888569,700,0.4442857142857143
YPR174C,16,888741,888955,214,0.3177570093457944
DPB2,16,888740,888954,214,0.3177570093457944
BET2,16,892084,892302,218,0.3394495412844037
PRP4,16,892083,892301,218,0.3394495412844037
HDA3,16,895797,895935,138,0.2753623188405797
AOS1,16,895796,895934,138,0.2753623188405797
SEC23,16,899727,900132,405,0.4271604938271605
SMX3,16,899726,900131,405,0.4271604938271605
DPM1,16,900530,900717,187,0.33689839572192515
GDB1,16,901644,901646,2,0.5
ATG13,16,906774,906907,133,0.3458646616541353
PZF1,16,911039,911241,202,0.24752475247524752
RPO26,16,911038,911240,202,0.2524752475247525
MLC2,16,912501,912635,134,0.26865671641791045
SKI3,16,912500,912634,134,0.26865671641791045
RPC82,16,919071,919321,250,0.356
QCR2,16,919070,919320,250,0.352
AQY1,16,921687,921844,157,0.3821656050955414
HPA2,16,923832,924139,307,0.3289902280130293
OPT2,16,927251,927951,700,0.37142857142857144
YPR196W,16,930646,931346,700,0.3757142857142857
SGE1,16,933278,933978,700,0.2842857142857143
ARR1,16,939042,939043,1,0.0
ARR2,16,941219,941919,700,0.3485714285714286
ARR3,16,939069,939769,700,0.3271428571428571
TIM10,8,115935,116635,700,0.3514285714285714
MOB2,6,64051,64173,122,0.26229508196721313
NHP6B,2,426899,427054,155,0.47096774193548385
MRP10,4,372037,372214,177,0.3898305084745763
ECM12,8,149167,149464,297,0.31313131313131315
CCW14,12,903479,903675,196,0.336734693877551
YAL064W-B,1,10612,11312,700,0.32
VMA10,8,187704,187908,204,0.35294117647058826
CWP2,11,258504,259204,700,0.4514285714285714
AIM11,5,348409,348575,166,0.43373493975903615
YOR304C-A,15,888756,888959,203,0.3448275862068966
HMRA1,3,293122,293822,700,0.34
YDR179W-A,4,819203,819339,136,0.29411764705882354
TMA20,5,166919,167619,700,0.3342857142857143
DDR2,15,231788,232328,540,0.4
YMR244C-A,13,758874,759574,700,0.46
RPL43B,10,607581,608281,700,0.37285714285714283
HOR7,13,774089,774710,621,0.4830917874396135
MAK31,3,155110,155288,178,0.3146067415730337
PMP1,3,163219,163362,143,0.2867132867132867
MTW1,1,79560,79694,134,0.31343283582089554
YMR316C-B,13,908197,908897,700,0.45714285714285713
YMR086C-A,13,443152,443300,148,0.36486486486486486
YCR087C-A,3,264503,265026,523,0.34990439770554493
YSY6,2,564718,565213,495,0.35353535353535354
QCR10,8,107596,107759,163,0.32515337423312884
RPL19A,2,415284,415908,624,0.41185897435897434
SOM1,5,42677,43226,549,0.42987249544626593
LSB3,6,203458,203656,198,0.40404040404040403
MEI4,5,239406,239901,495,0.34545454545454546
RPL34A,5,270208,270647,439,0.4031890660592255
SPC1,10,458391,458554,163,0.38650306748466257
YMR153C-A,13,565951,566011,60,0.31666666666666665
SBH2,5,194591,195101,510,0.41568627450980394
PMP2,5,122964,123616,652,0.43558282208588955
RPL2A,6,221447,222147,700,0.43
RPC10,8,386726,387202,476,0.3172268907563025
SOL2,3,246647,246944,297,0.3771043771043771
YMR119W-A,13,505147,505149,2,0.0
SFT1,11,430674,431374,700,0.3457142857142857
YML100W-A,13,68268,68413,145,0.46206896551724136
FRM2,3,75384,75936,552,0.34057971014492755
ERP1,1,154746,154920,174,0.27586206896551724
YMR173W-A,13,608177,608642,465,0.37849462365591396
RPS30A,12,713187,713319,132,0.3409090909090909
YMR304C-A,13,880351,880357,6,0.0
EST3,9,336224,336924,700,0.32571428571428573
SCS22,2,47192,47263,71,0.38028169014084506
RPL36B,16,76275,76604,329,0.46200607902735563
SMX2,6,103205,103677,472,0.3644067796610169
ATP18,13,104221,104632,411,0.35279805352798055
ISD11,5,249936,250636,700,0.3514285714285714
TIM11,4,1112318,1112333,15,0.26666666666666666
SEM1,4,1201405,1202105,700,0.3242857142857143
TMA7,12,669684,669842,158,0.33544303797468356
COX19,12,109027,109727,700,0.4085714285714286
YDR034W-B,4,520590,521290,700,0.3385714285714286
TIM9,5,117050,117177,127,0.3543307086614173
TOM5,16,797284,797523,239,0.3723849372384937
RTC6,16,198459,199010,551,0.3938294010889292
YCL001W-A,3,112562,112792,230,0.30434782608695654
SNA2,4,1490375,1490559,184,0.483695652173913
RPL41B,4,221819,222292,473,0.3699788583509514
LSM3,12,1014237,1014441,204,0.4117647058823529
RPL29,6,223802,224183,381,0.3228346456692913
RPL22B,6,64974,65307,333,0.32432432432432434
YER039C-A,5,229498,229713,215,0.40930232558139534
HTL1,3,155109,155287,178,0.3146067415730337
MBF1,15,877739,878327,588,0.4387755102040816
RIM1,3,173501,173653,152,0.34868421052631576
HUB1,14,687495,687629,134,0.4552238805970149
YMR194C-A,13,653161,653861,700,0.45571428571428574
DID2,11,507833,507921,88,0.3522727272727273
YKL033W-A,11,374191,374412,221,0.3257918552036199
VID28,9,321035,321429,394,0.37817258883248733
STF1,4,228816,229114,298,0.35906040268456374
MDM35,11,339517,339628,111,0.3963963963963964
YAL063C-A,1,23633,24333,700,0.3442857142857143
YAL044W-A,1,57414,57516,102,0.35294117647058826
NCE101,10,50460,50557,97,0.422680412371134
YJL133C-A,10,159872,160534,662,0.3957703927492447
YJL127C-B,10,181810,181823,13,0.38461538461538464
YJL077W-B,10,292024,292724,700,0.48428571428571426
YJL077W-A,10,294056,294644,588,0.44047619047619047
COA3,10,316504,316694,190,0.43157894736842106
YJL047C-A,10,349232,349501,269,0.3680297397769517
YJR005C-A,10,448731,449194,463,0.3563714902807775
YJR112W-A,10,637686,637756,70,0.42857142857142855
TIM8,10,676829,676950,121,0.3140495867768595
YKL145W-A,11,173946,174181,235,0.34893617021276596
HSK3,11,185034,185183,149,0.3221476510067114
YKL106C-A,11,237269,237438,169,0.33136094674556216
YKL068W-A,11,308460,309160,700,0.4157142857142857
YKL023C-A,11,393410,393694,284,0.3380281690140845
YKL018C-A,11,403920,404062,142,0.29577464788732394
YKR075W-A,11,579164,579216,52,0.34615384615384615
PCC1,11,625595,625849,254,0.38976377952755903
YLR099W-A,12,340978,341290,312,0.46794871794871795
YLR120W-A,12,388332,388550,218,0.3944954128440367
YLR146W-A,12,433766,433848,82,0.2804878048780488
YLR285C-A,12,710367,710763,396,0.3838383838383838
YLR286W-A,12,708276,708446,170,0.3
YLR307C-A,12,747603,748303,700,0.37285714285714283
YLR342W-A,12,813905,814605,700,0.38571428571428573
YLR361C-A,12,849696,849827,131,0.3816793893129771
YLR363W-A,12,853229,853448,219,0.2922374429223744
YLR437C-A,12,1013313,1013805,492,0.5040650406504065
YML116W-A,13,35358,36058,700,0.35714285714285715
YML101C-A,13,69747,69753,6,0.8333333333333334
HUG1,13,158316,158712,396,0.3207070707070707
YML009W-B,13,247655,247658,3,0.6666666666666666
MRPL39,13,251558,251748,190,0.39473684210526316
YML007C-A,13,253283,253686,403,0.44168734491315137
YMR013C-A,13,296808,297508,700,0.3157142857142857
YMR013W-A,13,297436,298136,700,0.33285714285714285
SAM37,13,392536,392731,195,0.30256410256410254
YMR122W-A,13,510683,511270,587,0.4395229982964225
YMR158C-A,13,574830,574910,80,0.375
ALD3,13,601196,601424,228,0.35526315789473684
PAI3,13,610399,610978,579,0.39378238341968913
SIP18,13,610398,610977,579,0.39378238341968913
YMR182W-A,13,623477,623503,26,0.15384615384615385
CMC4,13,652900,653161,261,0.44061302681992337
YMR230W-A,13,731681,732381,700,0.34285714285714286
COX7,13,779159,779377,218,0.38073394495412843
ZDS1,13,814176,814302,126,0.373015873015873
MRPL33,13,841698,841924,226,0.336283185840708
YMR315W-A,13,903959,904017,58,0.25862068965517243
YNL277W-A,14,116643,116682,39,0.38461538461538464
YNL162W-A,14,330137,330311,174,0.3275862068965517
YSF3,14,365285,365985,700,0.38571428571428573
YNL103W-A,14,425369,426069,700,0.4514285714285714
YNL097W-A,14,441245,441301,56,0.35714285714285715
KSH1,14,586878,587004,126,0.4126984126984127
YNR001W-A,14,631160,631205,45,0.35555555555555557
EGO4,14,691788,692488,700,0.38857142857142857
YOL159C-A,15,15587,16287,700,0.3557142857142857
YOL097W-A,15,135136,135836,700,0.4057142857142857
YOL086W-A,15,158917,159124,207,0.3526570048309179
YOL085W-A,15,160631,161138,507,0.3806706114398422
ATP19,15,185241,185403,162,0.3950617283950617
YOL038C-A,15,255085,255306,221,0.3891402714932127
YOL019W-A,15,288063,288464,401,0.3865336658354115
YOR008W-B,15,342962,343662,700,0.38142857142857145
YOR011W-A,15,355117,355817,700,0.30428571428571427
YOR020W-A,15,370938,371638,700,0.3457142857142857
YOR032W-A,15,390034,390734,700,0.36
YOR034C-A,15,399293,399993,700,0.3557142857142857
YOR161W-A,15,636841,637140,299,0.34448160535117056
YOR161W-B,15,636841,637140,299,0.34448160535117056
YOR316C-A,15,908170,908870,700,0.38571428571428573
YOR376W-A,15,1044010,1044710,700,0.4228571428571429
YOR381W-A,15,1056669,1057369,700,0.40714285714285714
COA2,16,188604,189032,428,0.36682242990654207
YPL119C-A,16,326324,326330,6,0.5
ERI1,16,366782,366905,123,0.37398373983739835
YPR010C-A,16,582786,582857,71,0.30985915492957744
YPR036W-A,16,645361,645874,513,0.5165692007797271
YPR145C-A,16,824923,825142,219,0.3378995433789954
YPR160W-A,16,860482,861182,700,0.42142857142857143
YPR169W-A,16,882752,883210,458,0.3624454148471616
YPR170W-B,16,882752,883210,458,0.3624454148471616
YPR170W-A,16,882752,883210,458,0.3624454148471616
YBL071C-B,2,89610,89943,333,0.4144144144144144
KTI11,2,89609,89942,333,0.4144144144144144
YBL068W-A,2,90653,90659,6,0.3333333333333333
CMC2,2,110561,110677,116,0.3275862068965517
YBL039W-B,2,142910,143107,197,0.40609137055837563
YBL039C-A,2,145783,146124,341,0.2961876832844575
YBL029C-A,2,164862,165562,700,0.44142857142857145
YBR056W-A,2,350527,351227,700,0.3414285714285714
TSC3,2,356620,356762,142,0.3873239436619718
YBR076C-A,2,391824,392339,515,0.3864077669902913
YBR085C-A,2,419208,419908,700,0.4142857142857143
SUS1,2,461880,462101,221,0.4072398190045249
YBR121C-A,2,483434,483774,340,0.3411764705882353
YBR126W-A,2,490483,490826,343,0.521865889212828
YBR126W-B,2,490483,490826,343,0.521865889212828
YBR141W-A,2,526897,527149,252,0.3888888888888889
YBR182C-A,2,595606,596018,412,0.3737864077669903
YBR191W-A,2,605572,606247,675,0.41185185185185186
YBR196C-A,2,615828,615870,42,0.47619047619047616
YBR196C-B,2,615870,615884,14,0.5714285714285714
YBR201C-A,2,624890,625590,700,0.3914285714285714
YBR230W-A,2,680077,680313,236,0.5169491525423728
DAD3,2,684818,684937,119,0.31932773109243695
YBR255C-A,2,727111,727331,220,0.35909090909090907
ADF1,3,23403,23561,158,0.2911392405063291
YCL057C-A,3,24353,24760,407,0.3857493857493858
YCL048W-A,3,40778,41416,638,0.3730407523510972
HBN1,3,74021,74492,471,0.39490445859872614
YCL021W-A,3,82829,83529,700,0.36142857142857143
YCL012C,3,101822,101965,143,0.3146853146853147
VMA9,3,106860,106997,137,0.35766423357664234
YCL001W-B,3,112562,112792,230,0.30434782608695654
YCR024C-B,3,163219,163362,143,0.2867132867132867
YCR045W-A,3,207956,208133,177,0.3333333333333333
YCR075W-A,3,248824,248960,136,0.3235294117647059
YCR095W-A,3,289295,289477,182,0.34615384615384615
YDL160C-A,4,169636,169968,332,0.2319277108433735
YDL086C-A,4,302219,302301,82,0.3170731707317073
YDL085C-A,4,302720,303145,425,0.4258823529411765
YDR003W-A,4,453833,454076,243,0.3374485596707819
HED1,4,477055,477755,700,0.35
TFB5,4,603845,603976,131,0.2824427480916031
YDR118W-A,4,685680,685864,184,0.3858695652173913
YDR119W-A,4,690589,690971,382,0.387434554973822
YDR183C-A,4,831542,831773,231,0.2987012987012987
SEC26,4,940849,940980,131,0.3435114503816794
AMD2,4,945999,946699,700,0.36142857142857143
PRP28,4,950313,950538,225,0.3466666666666667
PEX5,4,950312,950537,225,0.3466666666666667
MNN10,4,952575,952722,147,0.2857142857142857
YDR320W-B,4,1108200,1108255,55,0.23636363636363636
DAD4,4,1108521,1108671,150,0.3466666666666667
YDR374W-A,4,1224035,1224735,700,0.34
YDR379C-A,4,1233540,1234115,575,0.3791304347826087
YDR381C-A,4,1238851,1239411,560,0.3357142857142857
YDR461C-A,4,1385788,1386021,233,0.41630901287553645
YDR524C-B,4,1489843,1490376,533,0.4521575984990619
YDR524C-A,4,1490376,1490560,184,0.4782608695652174
YEL034C-A,5,86268,86886,618,0.3737864077669903
YEL008C-A,5,140992,141261,269,0.40892193308550184
YER038W-A,5,228347,228378,31,0.22580645161290322
YER053C-A,5,261092,261792,700,0.38285714285714284
YOS1,5,307300,307631,331,0.36253776435045315
SBH1,5,332870,333032,162,0.345679012345679
YER088W-B,5,333031,333089,58,0.20689655172413793
YER088C-A,5,337652,337657,5,0.4
YER137W-A,5,438820,439520,700,0.3757142857142857
YER175W-A,5,539296,539493,197,0.3553299492385787
SLO1,5,551148,551422,274,0.3905109489051095
YFL041W-A,6,47767,47889,122,0.4262295081967213
YFR009W-A,6,161730,162430,700,0.32
YFR012W-A,6,167289,167976,687,0.2954876273653566
YFR034W-A,6,224875,225575,700,0.5714285714285714
YFR052C-A,6,255156,255856,700,0.4085714285714286
YGL258W-A,7,7514,8214,700,0.3742857142857143
YGL194C-A,7,140198,140393,195,0.26666666666666666
YGL188C-A,7,148997,149421,424,0.419811320754717
YGL041C-B,7,419246,419318,72,0.4027777777777778
YGL041W-A,7,418637,418813,176,0.26704545454545453
YGL007C-A,7,483949,483969,20,0.35
YGR121W-A,7,732973,733245,272,0.3382352941176471
YGR146C-A,7,785545,785936,391,0.48081841432225064
YGR161W-C,7,809513,810183,670,0.4582089552238806
YGR169C-A,7,836728,837086,358,0.3016759776536313
YGR174W-A,7,845753,845858,105,0.23809523809523808
EFG1,7,1038510,1039210,700,0.3457142857142857
YHL006W-A,8,96945,97645,700,0.39714285714285713
YHR007C-A,8,123675,124016,341,0.39589442815249265
YHR022C-A,8,151340,151625,285,0.32280701754385965
YHR032W-A,8,173224,173229,5,0.8
YHR050W-A,8,208195,208895,700,0.43
YHR069C-A,8,236032,236623,591,0.467005076142132
YHR071C-A,8,239261,239961,700,0.42714285714285716
NOP10,8,241406,241611,205,0.34146341463414637
YHR073W-A,8,241997,242503,506,0.3893280632411067
YHR073C-B,8,245940,246127,187,0.3422459893048128
IGO2,8,369835,370020,185,0.35135135135135137
YHR175W-A,8,452772,452920,148,0.3918918918918919
YHR180C-B,8,467071,467195,124,0.23387096774193547
YHR182C-A,8,471533,472233,700,0.43857142857142856
YHR193C-A,8,489082,489782,700,0.43857142857142856
NBL1,8,498890,499055,165,0.38181818181818183
YIL156W-B,9,47550,47676,126,0.36507936507936506
YIL134C-A,9,96974,97371,397,0.3224181360201511
YIL102C-A,9,173642,174342,700,0.39285714285714285
YIL047C-A,9,267245,267841,596,0.4983221476510067
YIL046W-A,9,267840,268115,275,0.4254545454545455
YIL030W-A,9,294492,295192,700,0.3585714285714286
YIL014C-A,9,325605,325929,324,0.345679012345679
YIL002W-A,9,350087,350272,185,0.33513513513513515
YIR018C-A,9,386485,387185,700,0.42142857142857143
